Unique ID,Date Time,Venue,Postal Code,Game Type,Total buy in,Prize Pool,Rake,Prize Pool Ratio,Additional Info
0,1/26/2023 7:00:00 pm,Pensacola Greyhound Track,32506,NLH,120,85,35,0.7083333333333334,Thursday $120 DEEP STACK
1,1/27/2023 12:00:00 pm,bestbet Jacksonville,32225,NLH,400,325,75,0.8125,2023 Winter Open - Event #1 - No Limit Hold'em
2,1/27/2023 3:00:00 pm,bestbet Jacksonville,32225,NLH,100,75,25,0.75,Satellite into Event 1
3,1/27/2023 6:00:00 pm,bestbet Jacksonville,32225,NLH,400,325,75,0.8125,2023 Winter Open - Event #1 - No Limit Hold'em
4,1/27/2023 7:00:00 pm,bestbet St. Augustine,32084,NLH,160,125,35,0.78125,$160 NLH SIX HOUR IRON MAN
5,1/28/2023 12:00:00 pm,bestbet St. Augustine,32084,NLH,160,125,35,0.78125,$160 NLH
6,1/28/2023 12:00:00 pm,bestbet Jacksonville,32225,NLH,400,325,75,0.8125,2023 Winter Open - Event #1 - No Limit Hold'em
7,1/28/2023 1:00:00 pm,Pensacola Greyhound Track,32506,NLH,120,85,35,0.7083333333333334,Saturday $120 DEEP STACK
8,1/28/2023 6:00:00 pm,bestbet Jacksonville,32225,NLH,400,325,75,0.8125,2023 Winter Open - Event #1 - No Limit Hold'em
9,1/28/2023 7:00:00 pm,bestbet St. Augustine,32084,NLH,100,75,25,0.75,$100 NLH
10,1/29/2023 12:00:00 pm,bestbet Orange Park,32073,NLH,60,40,20,0.6666666666666666,No-Limit Hold'em
11,1/29/2023 1:00:00 pm,bestbet Jacksonville,32225,NLH,400,330,70,0.825,2023 Winter Open - Event #2 - No Limit Hold'em Bounty
12,1/29/2023 1:00:00 pm,Pensacola Greyhound Track,32506,NLH,120,85,35,0.7083333333333334,Sunday $120 DEEP STACK
13,1/29/2023 2:00:00 pm,Ebro Poker Room,32437,NLH,300,255,45,0.85,No-Limit Hold'em Deep Stack
14,1/29/2023 7:00:00 pm,bestbet St. Augustine,32084,NLH,140,110,30,0.7857142857142857,$140 NLH W/$25 BOUNTIES
15,1/30/2023 12:00:00 pm,bestbet St. Augustine,32084,NLH,60,40,20,0.6666666666666666,$60 NLH
16,1/30/2023 12:00:00 pm,bestbet Jacksonville,32225,NLH,300,240,60,0.8,2023 Winter Open - Event #3 - No Limit Hold'em
17,1/31/2023 12:00:00 pm,bestbet St. Augustine,32084,NLH,60,40,20,0.6666666666666666,$60 NLH
18,1/31/2023 12:00:00 pm,bestbet Jacksonville,32225,NLH,400,330,70,0.825,2023 Winter Open - Event #4 - No Limit Hold'em
19,1/31/2023 6:00:00 pm,Ebro Poker Room,32437,NLH,80,57,23,0.7125,No-Limit Hold'em - 9-Handed
20,1/31/2023 7:00:00 pm,bestbet Orange Park,32073,NLH,60,40,20,0.6666666666666666,No-Limit Hold'em
21,1/31/2023 7:00:00 pm,Pensacola Greyhound Track,32506,NLH,120,85,35,0.7083333333333334,Tuesday $120 DEEP STACK
22,2/01/2023 12:00:00 pm,bestbet Jacksonville,32225,NLH,100,75,25,0.75,No-Limit Hold'em
23,2/01/2023 12:00:00 pm,bestbet Jacksonville,32225,NLH,300,240,60,0.8,2023 Winter Open - Event #5 - Ladies No Limit Hold'em
24,2/01/2023 1:00:00 pm,Pensacola Greyhound Track,32506,PLO,270,200,70,0.7407407407407407,Wednesday $270 PLO
25,2/01/2023 3:00:00 pm,bestbet Jacksonville,32225,NLH,400,330,70,0.825,2023 Winter Open - Event #6 - No Limit Hold'em Bounty
26,2/01/2023 6:00:00 pm,Ebro Poker Room,32437,NLH,120,95,25,0.7916666666666666,"No-Limit Hold'em - 9-Handed ($3,000 Guaranteed)"
27,2/02/2023 6:00:00 pm,Ebro Poker Room,32437,NLH,220,190,30,0.8636363636363636,"No-Limit Hold'em - 9-Handed ($6,000 Guaranteed)"
28,2/02/2023 7:00:00 pm,bestbet Orange Park,32073,NLH,100,75,25,0.75,No-Limit Hold'em
29,2/02/2023 7:00:00 pm,Pensacola Greyhound Track,32506,NLH,120,85,35,0.7083333333333334,Thursday $120 DEEP STACK
30,2/03/2023 12:00:00 pm,bestbet Jacksonville,32225,NLH,200,160,40,0.8,No-Limit Hold'em
31,2/04/2023 1:00:00 pm,Pensacola Greyhound Track,32506,NLH,120,85,35,0.7083333333333334,Saturday $120 DEEP STACK
32,2/05/2023 12:00:00 pm,bestbet Jacksonville,32225,NLH,200,160,40,0.8,No-Limit Hold'em
33,2/05/2023 12:00:00 pm,bestbet Orange Park,32073,NLH,60,40,20,0.6666666666666666,No-Limit Hold'em
34,2/05/2023 1:00:00 pm,Pensacola Greyhound Track,32506,NLH,120,85,35,0.7083333333333334,Sunday $120 DEEP STACK
35,2/06/2023 7:00:00 pm,bestbet Jacksonville,32225,NLH,100,75,25,0.75,No-Limit Hold'em
36,2/07/2023 6:00:00 pm,Ebro Poker Room,32437,NLH,80,57,23,0.7125,No-Limit Hold'em - 9-Handed
37,2/07/2023 7:00:00 pm,bestbet Orange Park,32073,NLH,60,40,20,0.6666666666666666,No-Limit Hold'em
38,2/08/2023 12:00:00 pm,bestbet Jacksonville,32225,NLH,100,75,25,0.75,No-Limit Hold'em
39,2/08/2023 6:00:00 pm,Ebro Poker Room,32437,NLH,120,95,25,0.7916666666666666,"No-Limit Hold'em - 9-Handed ($3,000 Guaranteed)"
40,2/09/2023 6:00:00 pm,Ebro Poker Room,32437,NLH,220,190,30,0.8636363636363636,"No-Limit Hold'em - 9-Handed ($6,000 Guaranteed)"
41,2/09/2023 7:00:00 pm,bestbet Orange Park,32073,NLH,100,75,25,0.75,No-Limit Hold'em
42,2/10/2023 12:00:00 pm,bestbet Jacksonville,32225,NLH,200,160,40,0.8,No-Limit Hold'em
43,2/12/2023 12:00:00 pm,bestbet Jacksonville,32225,NLH,200,160,40,0.8,No-Limit Hold'em
44,2/12/2023 12:00:00 pm,bestbet Orange Park,32073,NLH,60,40,20,0.6666666666666666,No-Limit Hold'em
45,2/12/2023 2:00:00 pm,Ebro Poker Room,32437,NLH,300,255,45,0.85,No-Limit Hold'em Deep Stack
46,2/13/2023 7:00:00 pm,bestbet Jacksonville,32225,NLH,100,75,25,0.75,No-Limit Hold'em
47,2/14/2023 6:00:00 pm,Ebro Poker Room,32437,NLH,80,57,23,0.7125,No-Limit Hold'em - 9-Handed
48,2/14/2023 7:00:00 pm,bestbet Orange Park,32073,NLH,60,40,20,0.6666666666666666,No-Limit Hold'em
49,2/15/2023 12:00:00 pm,bestbet Jacksonville,32225,NLH,100,75,25,0.75,No-Limit Hold'em
50,2/15/2023 6:00:00 pm,Ebro Poker Room,32437,NLH,120,95,25,0.7916666666666666,"No-Limit Hold'em - 9-Handed ($3,000 Guaranteed)"
51,2/16/2023 6:00:00 pm,Ebro Poker Room,32437,NLH,220,190,30,0.8636363636363636,"No-Limit Hold'em - 9-Handed ($6,000 Guaranteed)"
52,2/16/2023 7:00:00 pm,bestbet Orange Park,32073,NLH,100,75,25,0.75,No-Limit Hold'em
53,2/17/2023 12:00:00 pm,bestbet Jacksonville,32225,NLH,200,160,40,0.8,No-Limit Hold'em
54,2/19/2023 12:00:00 pm,bestbet Jacksonville,32225,NLH,200,160,40,0.8,No-Limit Hold'em
55,2/19/2023 12:00:00 pm,bestbet Orange Park,32073,NLH,60,40,20,0.6666666666666666,No-Limit Hold'em
56,2/19/2023 2:00:00 pm,Ebro Poker Room,32437,NLH,300,255,45,0.85,No-Limit Hold'em Deep Stack
57,2/20/2023 7:00:00 pm,bestbet Jacksonville,32225,NLH,100,75,25,0.75,No-Limit Hold'em
58,2/21/2023 6:00:00 pm,Ebro Poker Room,32437,NLH,80,57,23,0.7125,No-Limit Hold'em - 9-Handed
59,2/21/2023 7:00:00 pm,bestbet Orange Park,32073,NLH,60,40,20,0.6666666666666666,No-Limit Hold'em
60,2/22/2023 12:00:00 pm,bestbet Jacksonville,32225,NLH,100,75,25,0.75,No-Limit Hold'em
61,2/22/2023 6:00:00 pm,Ebro Poker Room,32437,NLH,120,95,25,0.7916666666666666,"No-Limit Hold'em - 9-Handed ($3,000 Guaranteed)"
62,2/23/2023 6:00:00 pm,Ebro Poker Room,32437,NLH,220,190,30,0.8636363636363636,"No-Limit Hold'em - 9-Handed ($6,000 Guaranteed)"
63,2/23/2023 7:00:00 pm,bestbet Orange Park,32073,NLH,100,75,25,0.75,No-Limit Hold'em
64,2/24/2023 12:00:00 pm,bestbet Jacksonville,32225,NLH,200,160,40,0.8,No-Limit Hold'em
65,2/26/2023 12:00:00 pm,bestbet Jacksonville,32225,NLH,200,160,40,0.8,No-Limit Hold'em
66,2/26/2023 12:00:00 pm,bestbet Orange Park,32073,NLH,60,40,20,0.6666666666666666,No-Limit Hold'em
67,2/26/2023 2:00:00 pm,Ebro Poker Room,32437,NLH,300,255,45,0.85,No-Limit Hold'em Deep Stack
68,2/27/2023 7:00:00 pm,bestbet Jacksonville,32225,NLH,100,75,25,0.75,No-Limit Hold'em
69,2/28/2023 6:00:00 pm,Ebro Poker Room,32437,NLH,80,57,23,0.7125,No-Limit Hold'em - 9-Handed
70,2/28/2023 7:00:00 pm,bestbet Orange Park,32073,NLH,60,40,20,0.6666666666666666,No-Limit Hold'em
71,3/01/2023 12:00:00 pm,bestbet Jacksonville,32225,NLH,100,75,25,0.75,No-Limit Hold'em
72,3/01/2023 6:00:00 pm,Ebro Poker Room,32437,NLH,120,95,25,0.7916666666666666,"No-Limit Hold'em - 9-Handed ($3,000 Guaranteed)"
73,3/02/2023 6:00:00 pm,Ebro Poker Room,32437,NLH,220,190,30,0.8636363636363636,"No-Limit Hold'em - 9-Handed ($6,000 Guaranteed)"
74,3/02/2023 7:00:00 pm,bestbet Orange Park,32073,NLH,100,75,25,0.75,No-Limit Hold'em
75,3/03/2023 12:00:00 pm,bestbet Jacksonville,32225,NLH,200,160,40,0.8,No-Limit Hold'em
76,3/05/2023 2:00:00 pm,Ebro Poker Room,32437,NLH,300,255,45,0.85,No-Limit Hold'em Deep Stack
77,3/06/2023 7:00:00 pm,bestbet Jacksonville,32225,NLH,100,75,25,0.75,No-Limit Hold'em
78,3/07/2023 6:00:00 pm,Ebro Poker Room,32437,NLH,80,57,23,0.7125,No-Limit Hold'em - 9-Handed
79,3/07/2023 7:00:00 pm,bestbet Orange Park,32073,NLH,60,40,20,0.6666666666666666,No-Limit Hold'em
80,3/08/2023 12:00:00 pm,bestbet Jacksonville,32225,NLH,100,75,25,0.75,No-Limit Hold'em
81,3/08/2023 6:00:00 pm,Ebro Poker Room,32437,NLH,120,95,25,0.7916666666666666,"No-Limit Hold'em - 9-Handed ($3,000 Guaranteed)"
82,3/09/2023 6:00:00 pm,Ebro Poker Room,32437,NLH,220,190,30,0.8636363636363636,"No-Limit Hold'em - 9-Handed ($6,000 Guaranteed)"
83,3/09/2023 7:00:00 pm,bestbet Orange Park,32073,NLH,100,75,25,0.75,No-Limit Hold'em
84,3/10/2023 12:00:00 pm,bestbet Jacksonville,32225,NLH,200,160,40,0.8,No-Limit Hold'em
85,3/12/2023 12:00:00 pm,bestbet Jacksonville,32225,NLH,200,160,40,0.8,No-Limit Hold'em
86,3/12/2023 12:00:00 pm,bestbet Orange Park,32073,NLH,60,40,20,0.6666666666666666,No-Limit Hold'em
87,3/12/2023 2:00:00 pm,Ebro Poker Room,32437,NLH,300,255,45,0.85,No-Limit Hold'em Deep Stack
88,3/13/2023 7:00:00 pm,bestbet Jacksonville,32225,NLH,100,75,25,0.75,No-Limit Hold'em
89,3/14/2023 6:00:00 pm,Ebro Poker Room,32437,NLH,80,57,23,0.7125,No-Limit Hold'em - 9-Handed
90,3/14/2023 7:00:00 pm,bestbet Orange Park,32073,NLH,60,40,20,0.6666666666666666,No-Limit Hold'em
91,3/15/2023 12:00:00 pm,bestbet Jacksonville,32225,NLH,100,75,25,0.75,No-Limit Hold'em
92,1/14/2023 10:00:00 am,Riverside Resort & Casino,89029,NLH,18,10,8,0.5555555555555556,No Limit Hold'em
93,1/14/2023 10:00:00 am,Harrah's Laughlin,89029,NLH,65,53,12,0.8153846153846154,No Limit Hold'em
94,1/14/2023 7:00:00 pm,Riverside Resort & Casino,89029,NLH,65,55,10,0.8461538461538461,No Limit Hold'em
95,1/14/2023 7:00:00 pm,Harrah's Laughlin,89029,NLH,95,76,19,0.8,No Limit Hold'em
96,1/15/2023 10:00:00 am,Riverside Resort & Casino,89029,NLH,18,10,8,0.5555555555555556,No Limit Hold'em
97,1/15/2023 10:00:00 am,Harrah's Laughlin,89029,NLH,65,53,12,0.8153846153846154,No Limit Hold'em
98,1/15/2023 7:00:00 pm,Riverside Resort & Casino,89029,NLH,35,25,10,0.7142857142857143,No Limit Hold'em
99,1/15/2023 7:00:00 pm,Harrah's Laughlin,89029,NLH,65,53,12,0.8153846153846154,No Limit Hold'em
100,1/16/2023 10:00:00 am,Riverside Resort & Casino,89029,NLH,18,10,8,0.5555555555555556,No Limit Hold'em
101,1/16/2023 10:00:00 am,Harrah's Laughlin,89029,NLH,50,40,10,0.8,No Limit Hold'em
102,1/16/2023 7:00:00 pm,Riverside Resort & Casino,89029,NLH,35,25,10,0.7142857142857143,No Limit Hold'em
103,1/16/2023 7:00:00 pm,Harrah's Laughlin,89029,NLH,65,53,12,0.8153846153846154,No Limit Hold'em
104,1/17/2023 10:00:00 am,Riverside Resort & Casino,89029,NLH,18,10,8,0.5555555555555556,No Limit Hold'em
105,1/17/2023 7:00:00 pm,Riverside Resort & Casino,89029,NLH,35,25,10,0.7142857142857143,No Limit Hold'em
106,1/18/2023 10:00:00 am,Riverside Resort & Casino,89029,NLH,18,10,8,0.5555555555555556,No Limit Hold'em
107,1/18/2023 7:00:00 pm,Riverside Resort & Casino,89029,NLO8,35,25,10,0.7142857142857143,Omaha 8/B
108,1/19/2023 10:00:00 am,Riverside Resort & Casino,89029,NLH,18,10,8,0.5555555555555556,No Limit Hold'em
109,1/19/2023 10:00:00 am,Harrah's Laughlin,89029,NLH,50,40,10,0.8,No Limit Hold'em
110,1/19/2023 7:00:00 pm,Harrah's Laughlin,89029,NLH,65,53,12,0.8153846153846154,No Limit Hold'em
111,1/20/2023 10:00:00 am,Riverside Resort & Casino,89029,NLH,18,10,8,0.5555555555555556,No Limit Hold'em
112,1/20/2023 10:00:00 am,Harrah's Laughlin,89029,NLH,50,40,10,0.8,No Limit Hold'em
113,1/20/2023 7:00:00 pm,Riverside Resort & Casino,89029,NLH,50,40,10,0.8,Friday Night Deepstack
114,1/20/2023 7:00:00 pm,Harrah's Laughlin,89029,NLH,75,61,14,0.8133333333333334,No Limit Hold'em
115,1/21/2023 10:00:00 am,Riverside Resort & Casino,89029,NLH,18,10,8,0.5555555555555556,No Limit Hold'em
116,1/21/2023 10:00:00 am,Harrah's Laughlin,89029,NLH,65,53,12,0.8153846153846154,No Limit Hold'em
117,1/21/2023 7:00:00 pm,Riverside Resort & Casino,89029,NLH,65,55,10,0.8461538461538461,No Limit Hold'em
118,1/21/2023 7:00:00 pm,Harrah's Laughlin,89029,NLH,95,76,19,0.8,No Limit Hold'em
119,1/22/2023 10:00:00 am,Riverside Resort & Casino,89029,NLH,18,10,8,0.5555555555555556,No Limit Hold'em
120,1/22/2023 10:00:00 am,Harrah's Laughlin,89029,NLH,65,53,12,0.8153846153846154,No Limit Hold'em
121,1/22/2023 7:00:00 pm,Riverside Resort & Casino,89029,NLH,35,25,10,0.7142857142857143,No Limit Hold'em
122,1/22/2023 7:00:00 pm,Harrah's Laughlin,89029,NLH,65,53,12,0.8153846153846154,No Limit Hold'em
123,1/23/2023 10:00:00 am,Riverside Resort & Casino,89029,NLH,18,10,8,0.5555555555555556,No Limit Hold'em
124,1/23/2023 10:00:00 am,Harrah's Laughlin,89029,NLH,50,40,10,0.8,No Limit Hold'em
125,1/23/2023 7:00:00 pm,Riverside Resort & Casino,89029,NLH,35,25,10,0.7142857142857143,No Limit Hold'em
126,1/23/2023 7:00:00 pm,Harrah's Laughlin,89029,NLH,65,53,12,0.8153846153846154,No Limit Hold'em
127,1/24/2023 10:00:00 am,Riverside Resort & Casino,89029,NLH,18,10,8,0.5555555555555556,No Limit Hold'em
128,1/24/2023 7:00:00 pm,Riverside Resort & Casino,89029,NLH,35,25,10,0.7142857142857143,No Limit Hold'em
129,1/25/2023 10:00:00 am,Riverside Resort & Casino,89029,NLH,18,10,8,0.5555555555555556,No Limit Hold'em
130,1/25/2023 7:00:00 pm,Riverside Resort & Casino,89029,NLO8,35,25,10,0.7142857142857143,Omaha 8/B
131,1/26/2023 10:00:00 am,Riverside Resort & Casino,89029,NLH,18,10,8,0.5555555555555556,No Limit Hold'em
132,1/26/2023 10:00:00 am,Harrah's Laughlin,89029,NLH,50,40,10,0.8,No Limit Hold'em
133,1/26/2023 7:00:00 pm,Harrah's Laughlin,89029,NLH,65,53,12,0.8153846153846154,No Limit Hold'em
134,1/27/2023 10:00:00 am,Riverside Resort & Casino,89029,NLH,18,10,8,0.5555555555555556,No Limit Hold'em
135,1/27/2023 10:00:00 am,Harrah's Laughlin,89029,NLH,50,40,10,0.8,No Limit Hold'em
136,1/27/2023 7:00:00 pm,Riverside Resort & Casino,89029,NLH,50,40,10,0.8,Friday Night Deepstack
137,1/27/2023 7:00:00 pm,Harrah's Laughlin,89029,NLH,75,61,14,0.8133333333333334,No Limit Hold'em
138,1/28/2023 10:00:00 am,Riverside Resort & Casino,89029,NLH,18,10,8,0.5555555555555556,No Limit Hold'em
139,1/28/2023 10:00:00 am,Harrah's Laughlin,89029,NLH,65,53,12,0.8153846153846154,No Limit Hold'em
140,1/28/2023 7:00:00 pm,Riverside Resort & Casino,89029,NLH,65,55,10,0.8461538461538461,No Limit Hold'em
141,1/28/2023 7:00:00 pm,Harrah's Laughlin,89029,NLH,95,76,19,0.8,No Limit Hold'em
142,1/29/2023 10:00:00 am,Riverside Resort & Casino,89029,NLH,18,10,8,0.5555555555555556,No Limit Hold'em
143,1/29/2023 10:00:00 am,Harrah's Laughlin,89029,NLH,65,53,12,0.8153846153846154,No Limit Hold'em
144,1/29/2023 7:00:00 pm,Riverside Resort & Casino,89029,NLH,35,25,10,0.7142857142857143,No Limit Hold'em
145,1/29/2023 7:00:00 pm,Harrah's Laughlin,89029,NLH,65,53,12,0.8153846153846154,No Limit Hold'em
146,1/30/2023 10:00:00 am,Riverside Resort & Casino,89029,NLH,18,10,8,0.5555555555555556,No Limit Hold'em
147,1/30/2023 10:00:00 am,Harrah's Laughlin,89029,NLH,50,40,10,0.8,No Limit Hold'em
148,1/30/2023 7:00:00 pm,Riverside Resort & Casino,89029,NLH,35,25,10,0.7142857142857143,No Limit Hold'em
149,1/30/2023 7:00:00 pm,Harrah's Laughlin,89029,NLH,65,53,12,0.8153846153846154,No Limit Hold'em
150,1/31/2023 10:00:00 am,Riverside Resort & Casino,89029,NLH,18,10,8,0.5555555555555556,No Limit Hold'em
151,1/31/2023 7:00:00 pm,Riverside Resort & Casino,89029,NLH,35,25,10,0.7142857142857143,No Limit Hold'em
152,2/01/2023 10:00:00 am,Riverside Resort & Casino,89029,NLH,18,10,8,0.5555555555555556,No Limit Hold'em
153,2/01/2023 7:00:00 pm,Riverside Resort & Casino,89029,NLO8,35,25,10,0.7142857142857143,Omaha 8/B
154,2/02/2023 10:00:00 am,Riverside Resort & Casino,89029,NLH,18,10,8,0.5555555555555556,No Limit Hold'em
155,2/02/2023 10:00:00 am,Harrah's Laughlin,89029,NLH,50,40,10,0.8,No Limit Hold'em
156,2/02/2023 7:00:00 pm,Harrah's Laughlin,89029,NLH,65,53,12,0.8153846153846154,No Limit Hold'em
157,2/03/2023 10:00:00 am,Riverside Resort & Casino,89029,NLH,18,10,8,0.5555555555555556,No Limit Hold'em
158,2/03/2023 10:00:00 am,Harrah's Laughlin,89029,NLH,50,40,10,0.8,No Limit Hold'em
159,2/03/2023 7:00:00 pm,Riverside Resort & Casino,89029,NLH,50,40,10,0.8,Friday Night Deepstack
160,2/03/2023 7:00:00 pm,Harrah's Laughlin,89029,NLH,75,61,14,0.8133333333333334,No Limit Hold'em
161,2/04/2023 10:00:00 am,Riverside Resort & Casino,89029,NLH,18,10,8,0.5555555555555556,No Limit Hold'em
162,2/04/2023 10:00:00 am,Harrah's Laughlin,89029,NLH,65,53,12,0.8153846153846154,No Limit Hold'em
163,2/04/2023 7:00:00 pm,Riverside Resort & Casino,89029,NLH,65,55,10,0.8461538461538461,No Limit Hold'em
164,2/04/2023 7:00:00 pm,Harrah's Laughlin,89029,NLH,95,76,19,0.8,No Limit Hold'em
165,2/05/2023 10:00:00 am,Riverside Resort & Casino,89029,NLH,18,10,8,0.5555555555555556,No Limit Hold'em
166,2/05/2023 10:00:00 am,Harrah's Laughlin,89029,NLH,65,53,12,0.8153846153846154,No Limit Hold'em
167,2/05/2023 7:00:00 pm,Riverside Resort & Casino,89029,NLH,35,25,10,0.7142857142857143,No Limit Hold'em
168,2/05/2023 7:00:00 pm,Harrah's Laughlin,89029,NLH,65,53,12,0.8153846153846154,No Limit Hold'em
169,2/06/2023 10:00:00 am,Riverside Resort & Casino,89029,NLH,18,10,8,0.5555555555555556,No Limit Hold'em
170,2/06/2023 10:00:00 am,Harrah's Laughlin,89029,NLH,50,40,10,0.8,No Limit Hold'em
171,2/06/2023 7:00:00 pm,Riverside Resort & Casino,89029,NLH,35,25,10,0.7142857142857143,No Limit Hold'em
172,2/06/2023 7:00:00 pm,Harrah's Laughlin,89029,NLH,65,53,12,0.8153846153846154,No Limit Hold'em
173,2/07/2023 10:00:00 am,Riverside Resort & Casino,89029,NLH,18,10,8,0.5555555555555556,No Limit Hold'em
174,2/07/2023 7:00:00 pm,Riverside Resort & Casino,89029,NLH,35,25,10,0.7142857142857143,No Limit Hold'em
175,2/08/2023 10:00:00 am,Riverside Resort & Casino,89029,NLH,18,10,8,0.5555555555555556,No Limit Hold'em
176,2/08/2023 7:00:00 pm,Riverside Resort & Casino,89029,NLO8,35,25,10,0.7142857142857143,Omaha 8/B
177,2/09/2023 10:00:00 am,Riverside Resort & Casino,89029,NLH,18,10,8,0.5555555555555556,No Limit Hold'em
178,2/09/2023 10:00:00 am,Harrah's Laughlin,89029,NLH,50,40,10,0.8,No Limit Hold'em
179,2/09/2023 7:00:00 pm,Harrah's Laughlin,89029,NLH,65,53,12,0.8153846153846154,No Limit Hold'em
180,2/10/2023 10:00:00 am,Riverside Resort & Casino,89029,NLH,18,10,8,0.5555555555555556,No Limit Hold'em
181,2/10/2023 10:00:00 am,Harrah's Laughlin,89029,NLH,50,40,10,0.8,No Limit Hold'em
182,2/10/2023 7:00:00 pm,Riverside Resort & Casino,89029,NLH,50,40,10,0.8,Friday Night Deepstack
183,2/10/2023 7:00:00 pm,Harrah's Laughlin,89029,NLH,75,61,14,0.8133333333333334,No Limit Hold'em
184,2/11/2023 10:00:00 am,Riverside Resort & Casino,89029,NLH,18,10,8,0.5555555555555556,No Limit Hold'em
185,2/11/2023 10:00:00 am,Harrah's Laughlin,89029,NLH,65,53,12,0.8153846153846154,No Limit Hold'em
186,2/11/2023 7:00:00 pm,Riverside Resort & Casino,89029,NLH,65,55,10,0.8461538461538461,No Limit Hold'em
187,2/11/2023 7:00:00 pm,Harrah's Laughlin,89029,NLH,95,76,19,0.8,No Limit Hold'em
188,2/12/2023 10:00:00 am,Riverside Resort & Casino,89029,NLH,18,10,8,0.5555555555555556,No Limit Hold'em
189,2/12/2023 10:00:00 am,Harrah's Laughlin,89029,NLH,65,53,12,0.8153846153846154,No Limit Hold'em
190,2/12/2023 7:00:00 pm,Riverside Resort & Casino,89029,NLH,35,25,10,0.7142857142857143,No Limit Hold'em
191,2/12/2023 7:00:00 pm,Harrah's Laughlin,89029,NLH,65,53,12,0.8153846153846154,No Limit Hold'em
192,2/13/2023 10:00:00 am,Riverside Resort & Casino,89029,NLH,18,10,8,0.5555555555555556,No Limit Hold'em
193,2/13/2023 10:00:00 am,Harrah's Laughlin,89029,NLH,50,40,10,0.8,No Limit Hold'em
194,2/13/2023 7:00:00 pm,Riverside Resort & Casino,89029,NLH,35,25,10,0.7142857142857143,No Limit Hold'em
195,2/13/2023 7:00:00 pm,Harrah's Laughlin,89029,NLH,65,53,12,0.8153846153846154,No Limit Hold'em
196,2/14/2023 10:00:00 am,Riverside Resort & Casino,89029,NLH,18,10,8,0.5555555555555556,No Limit Hold'em
197,2/14/2023 7:00:00 pm,Riverside Resort & Casino,89029,NLH,35,25,10,0.7142857142857143,No Limit Hold'em
198,2/15/2023 10:00:00 am,Riverside Resort & Casino,89029,NLH,18,10,8,0.5555555555555556,No Limit Hold'em
199,2/15/2023 7:00:00 pm,Riverside Resort & Casino,89029,NLO8,35,25,10,0.7142857142857143,Omaha 8/B
200,2/16/2023 10:00:00 am,Riverside Resort & Casino,89029,NLH,18,10,8,0.5555555555555556,No Limit Hold'em
201,2/16/2023 10:00:00 am,Harrah's Laughlin,89029,NLH,50,40,10,0.8,No Limit Hold'em
202,2/16/2023 7:00:00 pm,Harrah's Laughlin,89029,NLH,65,53,12,0.8153846153846154,No Limit Hold'em
203,2/17/2023 10:00:00 am,Riverside Resort & Casino,89029,NLH,18,10,8,0.5555555555555556,No Limit Hold'em
204,2/17/2023 10:00:00 am,Harrah's Laughlin,89029,NLH,50,40,10,0.8,No Limit Hold'em
205,2/17/2023 7:00:00 pm,Riverside Resort & Casino,89029,NLH,50,40,10,0.8,Friday Night Deepstack
206,2/17/2023 7:00:00 pm,Harrah's Laughlin,89029,NLH,75,61,14,0.8133333333333334,No Limit Hold'em
207,2/18/2023 10:00:00 am,Riverside Resort & Casino,89029,NLH,18,10,8,0.5555555555555556,No Limit Hold'em
208,2/18/2023 10:00:00 am,Harrah's Laughlin,89029,NLH,65,53,12,0.8153846153846154,No Limit Hold'em
209,2/18/2023 7:00:00 pm,Riverside Resort & Casino,89029,NLH,65,55,10,0.8461538461538461,No Limit Hold'em
210,2/18/2023 7:00:00 pm,Harrah's Laughlin,89029,NLH,95,76,19,0.8,No Limit Hold'em
211,2/19/2023 10:00:00 am,Riverside Resort & Casino,89029,NLH,18,10,8,0.5555555555555556,No Limit Hold'em
212,2/19/2023 10:00:00 am,Harrah's Laughlin,89029,NLH,65,53,12,0.8153846153846154,No Limit Hold'em
213,2/19/2023 7:00:00 pm,Riverside Resort & Casino,89029,NLH,35,25,10,0.7142857142857143,No Limit Hold'em
214,2/19/2023 7:00:00 pm,Harrah's Laughlin,89029,NLH,65,53,12,0.8153846153846154,No Limit Hold'em
215,2/20/2023 10:00:00 am,Riverside Resort & Casino,89029,NLH,18,10,8,0.5555555555555556,No Limit Hold'em
216,2/20/2023 10:00:00 am,Harrah's Laughlin,89029,NLH,50,40,10,0.8,No Limit Hold'em
217,2/20/2023 7:00:00 pm,Riverside Resort & Casino,89029,NLH,35,25,10,0.7142857142857143,No Limit Hold'em
218,2/20/2023 7:00:00 pm,Harrah's Laughlin,89029,NLH,65,53,12,0.8153846153846154,No Limit Hold'em
219,2/21/2023 10:00:00 am,Riverside Resort & Casino,89029,NLH,18,10,8,0.5555555555555556,No Limit Hold'em
220,2/21/2023 7:00:00 pm,Riverside Resort & Casino,89029,NLH,35,25,10,0.7142857142857143,No Limit Hold'em
221,2/22/2023 10:00:00 am,Riverside Resort & Casino,89029,NLH,18,10,8,0.5555555555555556,No Limit Hold'em
222,2/22/2023 7:00:00 pm,Riverside Resort & Casino,89029,NLO8,35,25,10,0.7142857142857143,Omaha 8/B
223,2/23/2023 10:00:00 am,Riverside Resort & Casino,89029,NLH,18,10,8,0.5555555555555556,No Limit Hold'em
224,2/23/2023 10:00:00 am,Harrah's Laughlin,89029,NLH,50,40,10,0.8,No Limit Hold'em
225,2/23/2023 7:00:00 pm,Harrah's Laughlin,89029,NLH,65,53,12,0.8153846153846154,No Limit Hold'em
226,2/24/2023 10:00:00 am,Riverside Resort & Casino,89029,NLH,18,10,8,0.5555555555555556,No Limit Hold'em
227,2/24/2023 10:00:00 am,Harrah's Laughlin,89029,NLH,50,40,10,0.8,No Limit Hold'em
228,2/24/2023 7:00:00 pm,Riverside Resort & Casino,89029,NLH,50,40,10,0.8,Friday Night Deepstack
229,2/24/2023 7:00:00 pm,Harrah's Laughlin,89029,NLH,75,61,14,0.8133333333333334,No Limit Hold'em
230,2/25/2023 10:00:00 am,Riverside Resort & Casino,89029,NLH,18,10,8,0.5555555555555556,No Limit Hold'em
231,2/25/2023 10:00:00 am,Harrah's Laughlin,89029,NLH,65,53,12,0.8153846153846154,No Limit Hold'em
232,2/25/2023 7:00:00 pm,Riverside Resort & Casino,89029,NLH,65,55,10,0.8461538461538461,No Limit Hold'em
233,2/25/2023 7:00:00 pm,Harrah's Laughlin,89029,NLH,95,76,19,0.8,No Limit Hold'em
234,2/26/2023 10:00:00 am,Riverside Resort & Casino,89029,NLH,18,10,8,0.5555555555555556,No Limit Hold'em
235,2/26/2023 10:00:00 am,Harrah's Laughlin,89029,NLH,65,53,12,0.8153846153846154,No Limit Hold'em
236,2/26/2023 7:00:00 pm,Riverside Resort & Casino,89029,NLH,35,25,10,0.7142857142857143,No Limit Hold'em
237,2/26/2023 7:00:00 pm,Harrah's Laughlin,89029,NLH,65,53,12,0.8153846153846154,No Limit Hold'em
238,2/27/2023 10:00:00 am,Riverside Resort & Casino,89029,NLH,18,10,8,0.5555555555555556,No Limit Hold'em
239,2/27/2023 10:00:00 am,Harrah's Laughlin,89029,NLH,50,40,10,0.8,No Limit Hold'em
240,2/27/2023 7:00:00 pm,Riverside Resort & Casino,89029,NLH,35,25,10,0.7142857142857143,No Limit Hold'em
241,2/27/2023 7:00:00 pm,Harrah's Laughlin,89029,NLH,65,53,12,0.8153846153846154,No Limit Hold'em
242,2/28/2023 10:00:00 am,Riverside Resort & Casino,89029,NLH,18,10,8,0.5555555555555556,No Limit Hold'em
243,2/28/2023 7:00:00 pm,Riverside Resort & Casino,89029,NLH,35,25,10,0.7142857142857143,No Limit Hold'em
244,3/01/2023 10:00:00 am,Riverside Resort & Casino,89029,NLH,18,10,8,0.5555555555555556,No Limit Hold'em
245,3/01/2023 7:00:00 pm,Riverside Resort & Casino,89029,NLO8,35,25,10,0.7142857142857143,Omaha 8/B
246,3/02/2023 10:00:00 am,Riverside Resort & Casino,89029,NLH,18,10,8,0.5555555555555556,No Limit Hold'em
247,3/02/2023 10:00:00 am,Harrah's Laughlin,89029,NLH,50,40,10,0.8,No Limit Hold'em
248,3/02/2023 7:00:00 pm,Harrah's Laughlin,89029,NLH,65,53,12,0.8153846153846154,No Limit Hold'em
249,3/03/2023 10:00:00 am,Riverside Resort & Casino,89029,NLH,18,10,8,0.5555555555555556,No Limit Hold'em
250,3/03/2023 10:00:00 am,Harrah's Laughlin,89029,NLH,50,40,10,0.8,No Limit Hold'em
251,3/03/2023 7:00:00 pm,Riverside Resort & Casino,89029,NLH,50,40,10,0.8,Friday Night Deepstack
252,3/03/2023 7:00:00 pm,Harrah's Laughlin,89029,NLH,75,61,14,0.8133333333333334,No Limit Hold'em
253,3/04/2023 10:00:00 am,Riverside Resort & Casino,89029,NLH,18,10,8,0.5555555555555556,No Limit Hold'em
254,3/04/2023 10:00:00 am,Harrah's Laughlin,89029,NLH,65,53,12,0.8153846153846154,No Limit Hold'em
255,3/04/2023 7:00:00 pm,Riverside Resort & Casino,89029,NLH,65,55,10,0.8461538461538461,No Limit Hold'em
256,3/04/2023 7:00:00 pm,Harrah's Laughlin,89029,NLH,95,76,19,0.8,No Limit Hold'em
257,3/05/2023 10:00:00 am,Riverside Resort & Casino,89029,NLH,18,10,8,0.5555555555555556,No Limit Hold'em
258,3/05/2023 10:00:00 am,Harrah's Laughlin,89029,NLH,65,53,12,0.8153846153846154,No Limit Hold'em
259,3/05/2023 7:00:00 pm,Riverside Resort & Casino,89029,NLH,35,25,10,0.7142857142857143,No Limit Hold'em
260,3/05/2023 7:00:00 pm,Harrah's Laughlin,89029,NLH,65,53,12,0.8153846153846154,No Limit Hold'em
261,3/06/2023 10:00:00 am,Riverside Resort & Casino,89029,NLH,18,10,8,0.5555555555555556,No Limit Hold'em
262,3/06/2023 10:00:00 am,Harrah's Laughlin,89029,NLH,50,40,10,0.8,No Limit Hold'em
263,3/06/2023 7:00:00 pm,Riverside Resort & Casino,89029,NLH,35,25,10,0.7142857142857143,No Limit Hold'em
264,3/06/2023 7:00:00 pm,Harrah's Laughlin,89029,NLH,65,53,12,0.8153846153846154,No Limit Hold'em
265,3/07/2023 10:00:00 am,Riverside Resort & Casino,89029,NLH,18,10,8,0.5555555555555556,No Limit Hold'em
266,3/07/2023 7:00:00 pm,Riverside Resort & Casino,89029,NLH,35,25,10,0.7142857142857143,No Limit Hold'em
267,3/08/2023 10:00:00 am,Riverside Resort & Casino,89029,NLH,18,10,8,0.5555555555555556,No Limit Hold'em
268,3/08/2023 7:00:00 pm,Riverside Resort & Casino,89029,NLO8,35,25,10,0.7142857142857143,Omaha 8/B
269,3/09/2023 10:00:00 am,Riverside Resort & Casino,89029,NLH,18,10,8,0.5555555555555556,No Limit Hold'em
270,3/09/2023 10:00:00 am,Harrah's Laughlin,89029,NLH,50,40,10,0.8,No Limit Hold'em
271,3/09/2023 7:00:00 pm,Harrah's Laughlin,89029,NLH,65,53,12,0.8153846153846154,No Limit Hold'em
272,3/10/2023 10:00:00 am,Riverside Resort & Casino,89029,NLH,18,10,8,0.5555555555555556,No Limit Hold'em
273,3/10/2023 10:00:00 am,Harrah's Laughlin,89029,NLH,50,40,10,0.8,No Limit Hold'em
274,3/10/2023 7:00:00 pm,Riverside Resort & Casino,89029,NLH,50,40,10,0.8,Friday Night Deepstack
275,3/10/2023 7:00:00 pm,Harrah's Laughlin,89029,NLH,75,61,14,0.8133333333333334,No Limit Hold'em
276,3/11/2023 10:00:00 am,Riverside Resort & Casino,89029,NLH,18,10,8,0.5555555555555556,No Limit Hold'em
277,3/11/2023 10:00:00 am,Harrah's Laughlin,89029,NLH,65,53,12,0.8153846153846154,No Limit Hold'em
278,3/11/2023 7:00:00 pm,Riverside Resort & Casino,89029,NLH,65,55,10,0.8461538461538461,No Limit Hold'em
279,3/11/2023 7:00:00 pm,Harrah's Laughlin,89029,NLH,95,76,19,0.8,No Limit Hold'em
280,3/12/2023 10:00:00 am,Riverside Resort & Casino,89029,NLH,18,10,8,0.5555555555555556,No Limit Hold'em
281,3/12/2023 10:00:00 am,Harrah's Laughlin,89029,NLH,65,53,12,0.8153846153846154,No Limit Hold'em
282,3/12/2023 7:00:00 pm,Riverside Resort & Casino,89029,NLH,35,25,10,0.7142857142857143,No Limit Hold'em
283,3/12/2023 7:00:00 pm,Harrah's Laughlin,89029,NLH,65,53,12,0.8153846153846154,No Limit Hold'em
284,3/13/2023 10:00:00 am,Riverside Resort & Casino,89029,NLH,18,10,8,0.5555555555555556,No Limit Hold'em
285,3/13/2023 7:00:00 pm,Riverside Resort & Casino,89029,NLH,35,25,10,0.7142857142857143,No Limit Hold'em
286,3/13/2023 7:00:00 pm,Harrah's Laughlin,89029,NLH,65,53,12,0.8153846153846154,No Limit Hold'em
287,3/14/2023 10:00:00 am,Riverside Resort & Casino,89029,NLH,18,10,8,0.5555555555555556,No Limit Hold'em
288,3/14/2023 7:00:00 pm,Riverside Resort & Casino,89029,NLH,35,25,10,0.7142857142857143,No Limit Hold'em
289,3/15/2023 10:00:00 am,Riverside Resort & Casino,89029,NLH,18,10,8,0.5555555555555556,No Limit Hold'em
290,1/14/2023 11:00:00 am,Gila River Casino - Lone Butte,85226,NLH,350,300,50,0.8571428571428571,Queen of the Desert - Series Event - Ladies No Limit Hold'em
291,1/14/2023 7:00:00 pm,Hon-Dah Casino,85935,NLH,30,20,10,0.6666666666666666,No Limit Hold'em
292,1/15/2023 11:00:00 am,Gila River Casino - Lone Butte,85226,NLH,125,100,25,0.8,No Limit Hold'em Sunday Brunch Tournament
293,1/15/2023 1:00:00 pm,Desert Diamond Casino,85305,NLH,60,50,10,0.8333333333333334,No Limit Hold'em Bounty
294,1/15/2023 7:00:00 pm,Hon-Dah Casino,85935,NLCRPI,30,20,10,0.6666666666666666,Crazy Pineapple Tournament
295,1/16/2023 10:00:00 am,Desert Diamond Casino,85305,NLH,40,35,5,0.875,No Limit Hold'em
296,1/16/2023 11:00:00 am,Gila River Casino - Lone Butte,85226,NLH,65,46,19,0.7076923076923077,No Limit Hold'em
297,1/16/2023 11:15:00 am,Talking Stick Resort,85256,NLH,125,100,25,0.8,No-Limit Hold'em
298,1/17/2023 11:00:00 am,Gila River Casino - Lone Butte,85226,NLH,65,46,19,0.7076923076923077,No Limit Hold'em
299,1/17/2023 11:15:00 am,Talking Stick Resort,85256,NLH,125,100,25,0.8,No-Limit Hold'em
300,1/17/2023 7:00:00 pm,Hon-Dah Casino,85935,M,40,30,10,0.75,"Mix (Hold'em, Omaha 8, Crazy Pineapple)"
301,1/17/2023 7:00:00 pm,Desert Diamond Casino,85305,NLH,60,55,5,0.9166666666666666,No Limit Hold'em
302,1/17/2023 7:15:00 pm,Talking Stick Resort,85256,NLH,200,160,40,0.8,No Limit Hold'em
303,1/18/2023 11:00:00 am,Gila River Casino - Lone Butte,85226,NLH,65,46,19,0.7076923076923077,No Limit Hold'em
304,1/18/2023 11:15:00 am,Talking Stick Resort,85256,NLH,125,100,25,0.8,No-Limit Hold'em
305,1/18/2023 7:00:00 pm,Hon-Dah Casino,85935,NLH,40,30,10,0.75,No Limit Hold'em
306,1/18/2023 7:00:00 pm,Desert Diamond Casino,85305,NLH,60,50,10,0.8333333333333334,No Limit Hold'em
307,1/18/2023 7:00:00 pm,Gila River Casino - Lone Butte,85226,NLH,105,80,25,0.7619047619047619,No Limit Hold'em
308,1/18/2023 7:15:00 pm,Talking Stick Resort,85256,NLH,145,115,30,0.7931034482758621,No Limit Hold'em
309,1/19/2023 10:00:00 am,Desert Diamond Casino,85305,NLH,40,35,5,0.875,No Limit Hold'em
310,1/19/2023 11:00:00 am,Gila River Casino - Lone Butte,85226,NLH,65,46,19,0.7076923076923077,No Limit Hold'em
311,1/19/2023 11:15:00 am,Talking Stick Resort,85256,NLH,125,100,25,0.8,No-Limit Hold'em
312,1/19/2023 7:00:00 pm,Hon-Dah Casino,85935,NLO8,40,30,10,0.75,Omaha 8/B
313,1/19/2023 7:00:00 pm,Gila River Casino - Lone Butte,85226,NLH,105,80,25,0.7619047619047619,No Limit Hold'em
314,1/19/2023 7:15:00 pm,Talking Stick Resort,85256,NLH,145,115,30,0.7931034482758621,No Limit Hold'em
315,1/20/2023 11:00:00 am,Gila River Casino - Lone Butte,85226,NLH,65,46,19,0.7076923076923077,No Limit Hold'em
316,1/20/2023 11:15:00 am,Talking Stick Resort,85256,NLH,125,100,25,0.8,No-Limit Hold'em
317,1/20/2023 7:15:00 pm,Talking Stick Resort,85256,NLH,200,160,40,0.8,No Limit Hold'em
318,1/21/2023 11:00:00 am,Gila River Casino - Lone Butte,85226,NLH,235,200,35,0.851063829787234,No Limit Hold'em Bounty
319,1/21/2023 7:00:00 pm,Hon-Dah Casino,85935,NLH,30,20,10,0.6666666666666666,No Limit Hold'em
320,1/22/2023 11:00:00 am,Gila River Casino - Lone Butte,85226,NLH,125,100,25,0.8,No Limit Hold'em Sunday Brunch Tournament
321,1/22/2023 11:15:00 am,Talking Stick Resort,85256,NLH,200,160,40,0.8,No Limit Hold'em
322,1/22/2023 1:00:00 pm,Desert Diamond Casino,85305,NLH,60,50,10,0.8333333333333334,No Limit Hold'em Bounty
323,1/22/2023 7:00:00 pm,Hon-Dah Casino,85935,NLCRPI,30,20,10,0.6666666666666666,Crazy Pineapple Tournament
324,1/23/2023 10:00:00 am,Desert Diamond Casino,85305,NLH,40,35,5,0.875,No Limit Hold'em
325,1/23/2023 11:00:00 am,Gila River Casino - Lone Butte,85226,NLH,65,46,19,0.7076923076923077,No Limit Hold'em
326,1/23/2023 11:15:00 am,Talking Stick Resort,85256,NLH,125,100,25,0.8,No-Limit Hold'em
327,1/24/2023 11:00:00 am,Gila River Casino - Lone Butte,85226,NLH,65,46,19,0.7076923076923077,No Limit Hold'em
328,1/24/2023 11:15:00 am,Talking Stick Resort,85256,NLH,125,100,25,0.8,No-Limit Hold'em
329,1/24/2023 7:00:00 pm,Hon-Dah Casino,85935,M,40,30,10,0.75,"Mix (Hold'em, Omaha 8, Crazy Pineapple)"
330,1/24/2023 7:00:00 pm,Desert Diamond Casino,85305,NLH,60,55,5,0.9166666666666666,No Limit Hold'em
331,1/24/2023 7:15:00 pm,Talking Stick Resort,85256,NLH,200,160,40,0.8,No Limit Hold'em
332,1/25/2023 11:00:00 am,Gila River Casino - Lone Butte,85226,NLH,65,46,19,0.7076923076923077,No Limit Hold'em
333,1/25/2023 11:15:00 am,Talking Stick Resort,85256,NLH,125,100,25,0.8,No-Limit Hold'em
334,1/25/2023 7:00:00 pm,Hon-Dah Casino,85935,NLH,40,30,10,0.75,No Limit Hold'em
335,1/25/2023 7:00:00 pm,Desert Diamond Casino,85305,NLH,60,50,10,0.8333333333333334,No Limit Hold'em
336,1/25/2023 7:00:00 pm,Gila River Casino - Lone Butte,85226,NLH,105,80,25,0.7619047619047619,No Limit Hold'em
337,1/25/2023 7:15:00 pm,Talking Stick Resort,85256,NLH,145,115,30,0.7931034482758621,No Limit Hold'em
338,1/26/2023 10:00:00 am,Desert Diamond Casino,85305,NLH,40,35,5,0.875,No Limit Hold'em
339,1/26/2023 11:00:00 am,Gila River Casino - Lone Butte,85226,NLH,65,46,19,0.7076923076923077,No Limit Hold'em
340,1/26/2023 11:15:00 am,Talking Stick Resort,85256,NLH,125,100,25,0.8,No-Limit Hold'em
341,1/26/2023 7:00:00 pm,Hon-Dah Casino,85935,NLO8,40,30,10,0.75,Omaha 8/B
342,1/26/2023 7:00:00 pm,Gila River Casino - Lone Butte,85226,NLH,105,80,25,0.7619047619047619,No Limit Hold'em
343,1/26/2023 7:15:00 pm,Talking Stick Resort,85256,NLH,145,115,30,0.7931034482758621,No Limit Hold'em
344,1/27/2023 11:00:00 am,Gila River Casino - Lone Butte,85226,NLH,65,46,19,0.7076923076923077,No Limit Hold'em
345,1/27/2023 11:15:00 am,Talking Stick Resort,85256,NLH,125,100,25,0.8,No-Limit Hold'em
346,1/27/2023 7:15:00 pm,Talking Stick Resort,85256,NLH,200,160,40,0.8,No Limit Hold'em
347,1/28/2023 11:00:00 am,Gila River Casino - Lone Butte,85226,NLH,150,115,35,0.7666666666666667,No Limit Hold'em Double Point Tournament
348,1/28/2023 11:15:00 am,Talking Stick Resort,85256,NLH,160,125,35,0.78125,No Limit Hold'em
349,1/28/2023 7:00:00 pm,Hon-Dah Casino,85935,NLH,30,20,10,0.6666666666666666,No Limit Hold'em
350,1/29/2023 11:00:00 am,Gila River Casino - Lone Butte,85226,NLH,125,100,25,0.8,No Limit Hold'em Sunday Brunch Tournament
351,1/29/2023 11:15:00 am,Talking Stick Resort,85256,NLH,200,160,40,0.8,No Limit Hold'em
352,1/29/2023 1:00:00 pm,Desert Diamond Casino,85305,NLH,60,50,10,0.8333333333333334,No Limit Hold'em Bounty
353,1/29/2023 7:00:00 pm,Hon-Dah Casino,85935,NLCRPI,30,20,10,0.6666666666666666,Crazy Pineapple Tournament
354,1/30/2023 10:00:00 am,Desert Diamond Casino,85305,NLH,40,35,5,0.875,No Limit Hold'em
355,1/30/2023 11:00:00 am,Gila River Casino - Lone Butte,85226,NLH,65,46,19,0.7076923076923077,No Limit Hold'em
356,1/30/2023 11:15:00 am,Talking Stick Resort,85256,NLH,125,100,25,0.8,No-Limit Hold'em
357,1/31/2023 11:00:00 am,Gila River Casino - Lone Butte,85226,NLH,65,46,19,0.7076923076923077,No Limit Hold'em
358,1/31/2023 11:15:00 am,Talking Stick Resort,85256,NLH,125,100,25,0.8,No-Limit Hold'em
359,1/31/2023 7:00:00 pm,Hon-Dah Casino,85935,M,40,30,10,0.75,"Mix (Hold'em, Omaha 8, Crazy Pineapple)"
360,1/31/2023 7:00:00 pm,Desert Diamond Casino,85305,NLH,60,55,5,0.9166666666666666,No Limit Hold'em
361,1/31/2023 7:15:00 pm,Talking Stick Resort,85256,NLH,200,160,40,0.8,No Limit Hold'em
362,2/01/2023 11:00:00 am,Gila River Casino - Lone Butte,85226,NLH,65,46,19,0.7076923076923077,No Limit Hold'em
363,2/01/2023 11:15:00 am,Talking Stick Resort,85256,NLH,125,100,25,0.8,No-Limit Hold'em
364,2/01/2023 7:00:00 pm,Hon-Dah Casino,85935,NLH,40,30,10,0.75,No Limit Hold'em
365,2/01/2023 7:00:00 pm,Desert Diamond Casino,85305,NLH,60,50,10,0.8333333333333334,No Limit Hold'em
366,2/01/2023 7:00:00 pm,Gila River Casino - Lone Butte,85226,NLH,105,80,25,0.7619047619047619,No Limit Hold'em
367,2/01/2023 7:15:00 pm,Talking Stick Resort,85256,NLH,145,115,30,0.7931034482758621,No Limit Hold'em
368,2/02/2023 10:00:00 am,Desert Diamond Casino,85305,NLH,40,35,5,0.875,No Limit Hold'em
369,2/02/2023 11:00:00 am,Gila River Casino - Lone Butte,85226,NLH,65,46,19,0.7076923076923077,No Limit Hold'em
370,2/02/2023 11:15:00 am,Talking Stick Resort,85256,NLH,125,100,25,0.8,No-Limit Hold'em
371,2/02/2023 7:00:00 pm,Hon-Dah Casino,85935,NLO8,40,30,10,0.75,Omaha 8/B
372,2/02/2023 7:00:00 pm,Gila River Casino - Lone Butte,85226,NLH,105,80,25,0.7619047619047619,No Limit Hold'em
373,2/02/2023 7:15:00 pm,Talking Stick Resort,85256,NLH,145,115,30,0.7931034482758621,No Limit Hold'em
374,2/03/2023 11:00:00 am,Gila River Casino - Lone Butte,85226,NLH,65,46,19,0.7076923076923077,No Limit Hold'em
375,2/03/2023 11:15:00 am,Talking Stick Resort,85256,NLH,125,100,25,0.8,No-Limit Hold'em
376,2/03/2023 7:15:00 pm,Talking Stick Resort,85256,NLH,200,160,40,0.8,No Limit Hold'em
377,2/04/2023 11:00:00 am,Gila River Casino - Lone Butte,85226,NLH,235,200,35,0.851063829787234,No Limit Hold'em Bounty
378,2/04/2023 11:15:00 am,Talking Stick Resort,85256,NLH,345,300,45,0.8695652173913043,Big Stack No Limit Hold'em
379,2/04/2023 7:00:00 pm,Hon-Dah Casino,85935,NLH,30,20,10,0.6666666666666666,No Limit Hold'em
380,2/05/2023 11:00:00 am,Gila River Casino - Lone Butte,85226,NLH,125,100,25,0.8,No Limit Hold'em Sunday Brunch Tournament
381,2/05/2023 7:00:00 pm,Hon-Dah Casino,85935,NLCRPI,30,20,10,0.6666666666666666,Crazy Pineapple Tournament
382,2/06/2023 10:00:00 am,Desert Diamond Casino,85305,NLH,40,35,5,0.875,No Limit Hold'em
383,2/06/2023 11:00:00 am,Gila River Casino - Lone Butte,85226,NLH,65,46,19,0.7076923076923077,No Limit Hold'em
384,2/06/2023 11:15:00 am,Talking Stick Resort,85256,NLH,125,100,25,0.8,No-Limit Hold'em
385,2/07/2023 11:00:00 am,Gila River Casino - Lone Butte,85226,NLH,65,46,19,0.7076923076923077,No Limit Hold'em
386,2/07/2023 11:15:00 am,Talking Stick Resort,85256,NLH,125,100,25,0.8,No-Limit Hold'em
387,2/07/2023 7:00:00 pm,Desert Diamond Casino,85305,NLH,60,55,5,0.9166666666666666,No Limit Hold'em
388,2/07/2023 7:00:00 pm,Hon-Dah Casino,85935,M,40,30,10,0.75,"Mix (Hold'em, Omaha 8, Crazy Pineapple)"
389,2/07/2023 7:15:00 pm,Talking Stick Resort,85256,NLH,200,160,40,0.8,No Limit Hold'em
390,2/08/2023 11:00:00 am,Gila River Casino - Lone Butte,85226,NLH,65,46,19,0.7076923076923077,No Limit Hold'em
391,2/08/2023 11:15:00 am,Talking Stick Resort,85256,NLH,125,100,25,0.8,No-Limit Hold'em
392,2/08/2023 7:00:00 pm,Hon-Dah Casino,85935,NLH,40,30,10,0.75,No Limit Hold'em
393,2/08/2023 7:00:00 pm,Desert Diamond Casino,85305,NLH,60,50,10,0.8333333333333334,No Limit Hold'em
394,2/08/2023 7:00:00 pm,Gila River Casino - Lone Butte,85226,NLH,105,80,25,0.7619047619047619,No Limit Hold'em
395,2/08/2023 7:15:00 pm,Talking Stick Resort,85256,NLH,145,115,30,0.7931034482758621,No Limit Hold'em
396,2/09/2023 10:00:00 am,Desert Diamond Casino,85305,NLH,40,35,5,0.875,No Limit Hold'em
397,2/09/2023 11:00:00 am,Gila River Casino - Lone Butte,85226,NLH,65,46,19,0.7076923076923077,No Limit Hold'em
398,2/09/2023 11:15:00 am,Talking Stick Resort,85256,NLH,125,100,25,0.8,No-Limit Hold'em
399,2/09/2023 7:00:00 pm,Hon-Dah Casino,85935,NLO8,40,30,10,0.75,Omaha 8/B
400,2/09/2023 7:00:00 pm,Gila River Casino - Lone Butte,85226,NLH,105,80,25,0.7619047619047619,No Limit Hold'em
401,2/09/2023 7:15:00 pm,Talking Stick Resort,85256,NLH,145,115,30,0.7931034482758621,No Limit Hold'em
402,2/10/2023 11:00:00 am,Gila River Casino - Lone Butte,85226,NLH,65,46,19,0.7076923076923077,No Limit Hold'em
403,2/10/2023 11:15:00 am,Talking Stick Resort,85256,NLH,125,100,25,0.8,No-Limit Hold'em
404,2/10/2023 7:15:00 pm,Talking Stick Resort,85256,NLH,200,160,40,0.8,No Limit Hold'em
405,2/11/2023 11:00:00 am,Gila River Casino - Lone Butte,85226,NLH,235,200,35,0.851063829787234,No Limit Hold'em Bounty
406,2/11/2023 7:00:00 pm,Hon-Dah Casino,85935,NLH,30,20,10,0.6666666666666666,No Limit Hold'em
407,2/12/2023 11:00:00 am,Gila River Casino - Lone Butte,85226,NLH,125,100,25,0.8,No Limit Hold'em Sunday Brunch Tournament
408,2/12/2023 1:00:00 pm,Desert Diamond Casino,85305,NLH,60,50,10,0.8333333333333334,No Limit Hold'em Bounty
409,2/12/2023 7:00:00 pm,Hon-Dah Casino,85935,NLCRPI,30,20,10,0.6666666666666666,Crazy Pineapple Tournament
410,2/13/2023 10:00:00 am,Desert Diamond Casino,85305,NLH,40,35,5,0.875,No Limit Hold'em
411,2/13/2023 11:00:00 am,Gila River Casino - Lone Butte,85226,NLH,65,46,19,0.7076923076923077,No Limit Hold'em
412,2/13/2023 11:15:00 am,Talking Stick Resort,85256,NLH,125,100,25,0.8,No-Limit Hold'em
413,2/14/2023 11:00:00 am,Gila River Casino - Lone Butte,85226,NLH,65,46,19,0.7076923076923077,No Limit Hold'em
414,2/14/2023 11:15:00 am,Talking Stick Resort,85256,NLH,125,100,25,0.8,No-Limit Hold'em
415,2/14/2023 7:00:00 pm,Desert Diamond Casino,85305,NLH,60,55,5,0.9166666666666666,No Limit Hold'em
416,2/14/2023 7:00:00 pm,Hon-Dah Casino,85935,M,40,30,10,0.75,"Mix (Hold'em, Omaha 8, Crazy Pineapple)"
417,2/14/2023 7:15:00 pm,Talking Stick Resort,85256,NLH,200,160,40,0.8,No Limit Hold'em
418,2/15/2023 11:00:00 am,Gila River Casino - Lone Butte,85226,NLH,65,46,19,0.7076923076923077,No Limit Hold'em
419,2/15/2023 11:15:00 am,Talking Stick Resort,85256,NLH,125,100,25,0.8,No-Limit Hold'em
420,2/15/2023 7:00:00 pm,Hon-Dah Casino,85935,NLH,40,30,10,0.75,No Limit Hold'em
421,2/15/2023 7:00:00 pm,Desert Diamond Casino,85305,NLH,60,50,10,0.8333333333333334,No Limit Hold'em
422,2/15/2023 7:00:00 pm,Gila River Casino - Lone Butte,85226,NLH,105,80,25,0.7619047619047619,No Limit Hold'em
423,2/15/2023 7:15:00 pm,Talking Stick Resort,85256,NLH,145,115,30,0.7931034482758621,No Limit Hold'em
424,2/16/2023 10:00:00 am,Desert Diamond Casino,85305,NLH,40,35,5,0.875,No Limit Hold'em
425,2/16/2023 11:00:00 am,Gila River Casino - Lone Butte,85226,NLH,65,46,19,0.7076923076923077,No Limit Hold'em
426,2/16/2023 11:15:00 am,Talking Stick Resort,85256,NLH,125,100,25,0.8,No-Limit Hold'em
427,2/16/2023 7:00:00 pm,Hon-Dah Casino,85935,NLO8,40,30,10,0.75,Omaha 8/B
428,2/16/2023 7:00:00 pm,Gila River Casino - Lone Butte,85226,NLH,105,80,25,0.7619047619047619,No Limit Hold'em
429,2/16/2023 7:15:00 pm,Talking Stick Resort,85256,NLH,145,115,30,0.7931034482758621,No Limit Hold'em
430,2/17/2023 11:00:00 am,Gila River Casino - Lone Butte,85226,NLH,65,46,19,0.7076923076923077,No Limit Hold'em
431,2/17/2023 11:15:00 am,Talking Stick Resort,85256,NLH,125,100,25,0.8,No-Limit Hold'em
432,2/17/2023 7:15:00 pm,Talking Stick Resort,85256,NLH,200,160,40,0.8,No Limit Hold'em
433,2/18/2023 11:00:00 am,Gila River Casino - Lone Butte,85226,NLH,235,200,35,0.851063829787234,No Limit Hold'em Bounty
434,2/18/2023 7:00:00 pm,Hon-Dah Casino,85935,NLH,30,20,10,0.6666666666666666,No Limit Hold'em
435,2/19/2023 11:00:00 am,Gila River Casino - Lone Butte,85226,NLH,125,100,25,0.8,No Limit Hold'em Sunday Brunch Tournament
436,2/19/2023 1:00:00 pm,Desert Diamond Casino,85305,NLH,60,50,10,0.8333333333333334,No Limit Hold'em Bounty
437,2/19/2023 7:00:00 pm,Hon-Dah Casino,85935,NLCRPI,30,20,10,0.6666666666666666,Crazy Pineapple Tournament
438,2/20/2023 10:00:00 am,Desert Diamond Casino,85305,NLH,40,35,5,0.875,No Limit Hold'em
439,2/20/2023 11:00:00 am,Gila River Casino - Lone Butte,85226,NLH,65,46,19,0.7076923076923077,No Limit Hold'em
440,2/20/2023 11:15:00 am,Talking Stick Resort,85256,NLH,125,100,25,0.8,No-Limit Hold'em
441,2/21/2023 11:00:00 am,Gila River Casino - Lone Butte,85226,NLH,65,46,19,0.7076923076923077,No Limit Hold'em
442,2/21/2023 11:15:00 am,Talking Stick Resort,85256,NLH,125,100,25,0.8,No-Limit Hold'em
443,2/21/2023 7:00:00 pm,Desert Diamond Casino,85305,NLH,60,55,5,0.9166666666666666,No Limit Hold'em
444,2/21/2023 7:00:00 pm,Hon-Dah Casino,85935,M,40,30,10,0.75,"Mix (Hold'em, Omaha 8, Crazy Pineapple)"
445,2/21/2023 7:15:00 pm,Talking Stick Resort,85256,NLH,200,160,40,0.8,No Limit Hold'em
446,2/22/2023 11:00:00 am,Gila River Casino - Lone Butte,85226,NLH,65,46,19,0.7076923076923077,No Limit Hold'em
447,2/22/2023 11:15:00 am,Talking Stick Resort,85256,NLH,125,100,25,0.8,No-Limit Hold'em
448,2/22/2023 7:00:00 pm,Hon-Dah Casino,85935,NLH,40,30,10,0.75,No Limit Hold'em
449,2/22/2023 7:00:00 pm,Desert Diamond Casino,85305,NLH,60,50,10,0.8333333333333334,No Limit Hold'em
450,2/22/2023 7:00:00 pm,Gila River Casino - Lone Butte,85226,NLH,105,80,25,0.7619047619047619,No Limit Hold'em
451,2/22/2023 7:15:00 pm,Talking Stick Resort,85256,NLH,145,115,30,0.7931034482758621,No Limit Hold'em
452,2/23/2023 10:00:00 am,Desert Diamond Casino,85305,NLH,40,35,5,0.875,No Limit Hold'em
453,2/23/2023 11:00:00 am,Gila River Casino - Lone Butte,85226,NLH,65,46,19,0.7076923076923077,No Limit Hold'em
454,2/23/2023 11:15:00 am,Talking Stick Resort,85256,NLH,125,100,25,0.8,No-Limit Hold'em
455,2/23/2023 7:00:00 pm,Hon-Dah Casino,85935,NLO8,40,30,10,0.75,Omaha 8/B
456,2/23/2023 7:00:00 pm,Gila River Casino - Lone Butte,85226,NLH,105,80,25,0.7619047619047619,No Limit Hold'em
457,2/23/2023 7:15:00 pm,Talking Stick Resort,85256,NLH,145,115,30,0.7931034482758621,No Limit Hold'em
458,2/24/2023 11:00:00 am,Gila River Casino - Lone Butte,85226,NLH,65,46,19,0.7076923076923077,No Limit Hold'em
459,2/24/2023 11:15:00 am,Talking Stick Resort,85256,NLH,125,100,25,0.8,No-Limit Hold'em
460,2/24/2023 7:15:00 pm,Talking Stick Resort,85256,NLH,200,160,40,0.8,No Limit Hold'em
461,2/25/2023 11:00:00 am,Gila River Casino - Lone Butte,85226,NLH,150,115,35,0.7666666666666667,No Limit Hold'em Double Point Tournament
462,2/25/2023 7:00:00 pm,Hon-Dah Casino,85935,NLH,30,20,10,0.6666666666666666,No Limit Hold'em
463,2/26/2023 11:00:00 am,Gila River Casino - Lone Butte,85226,NLH,125,100,25,0.8,No Limit Hold'em Sunday Brunch Tournament
464,2/26/2023 1:00:00 pm,Desert Diamond Casino,85305,NLH,60,50,10,0.8333333333333334,No Limit Hold'em Bounty
465,2/26/2023 7:00:00 pm,Hon-Dah Casino,85935,NLCRPI,30,20,10,0.6666666666666666,Crazy Pineapple Tournament
466,2/27/2023 10:00:00 am,Desert Diamond Casino,85305,NLH,40,35,5,0.875,No Limit Hold'em
467,2/27/2023 11:00:00 am,Gila River Casino - Lone Butte,85226,NLH,65,46,19,0.7076923076923077,No Limit Hold'em
468,2/27/2023 11:15:00 am,Talking Stick Resort,85256,NLH,125,100,25,0.8,No-Limit Hold'em
469,2/28/2023 11:00:00 am,Gila River Casino - Lone Butte,85226,NLH,65,46,19,0.7076923076923077,No Limit Hold'em
470,2/28/2023 11:15:00 am,Talking Stick Resort,85256,NLH,125,100,25,0.8,No-Limit Hold'em
471,2/28/2023 7:00:00 pm,Desert Diamond Casino,85305,NLH,60,55,5,0.9166666666666666,No Limit Hold'em
472,2/28/2023 7:00:00 pm,Hon-Dah Casino,85935,M,40,30,10,0.75,"Mix (Hold'em, Omaha 8, Crazy Pineapple)"
473,2/28/2023 7:15:00 pm,Talking Stick Resort,85256,NLH,200,160,40,0.8,No Limit Hold'em
474,3/01/2023 11:00:00 am,Gila River Casino - Lone Butte,85226,NLH,65,46,19,0.7076923076923077,No Limit Hold'em
475,3/01/2023 11:15:00 am,Talking Stick Resort,85256,NLH,125,100,25,0.8,No-Limit Hold'em
476,3/01/2023 7:00:00 pm,Hon-Dah Casino,85935,NLH,40,30,10,0.75,No Limit Hold'em
477,3/01/2023 7:00:00 pm,Desert Diamond Casino,85305,NLH,60,50,10,0.8333333333333334,No Limit Hold'em
478,3/01/2023 7:00:00 pm,Gila River Casino - Lone Butte,85226,NLH,105,80,25,0.7619047619047619,No Limit Hold'em
479,3/01/2023 7:15:00 pm,Talking Stick Resort,85256,NLH,145,115,30,0.7931034482758621,No Limit Hold'em
480,3/02/2023 10:00:00 am,Desert Diamond Casino,85305,NLH,40,35,5,0.875,No Limit Hold'em
481,3/02/2023 11:00:00 am,Gila River Casino - Lone Butte,85226,NLH,65,46,19,0.7076923076923077,No Limit Hold'em
482,3/02/2023 11:15:00 am,Talking Stick Resort,85256,NLH,125,100,25,0.8,No-Limit Hold'em
483,3/02/2023 7:00:00 pm,Hon-Dah Casino,85935,NLO8,40,30,10,0.75,Omaha 8/B
484,3/02/2023 7:00:00 pm,Gila River Casino - Lone Butte,85226,NLH,105,80,25,0.7619047619047619,No Limit Hold'em
485,3/02/2023 7:15:00 pm,Talking Stick Resort,85256,NLH,145,115,30,0.7931034482758621,No Limit Hold'em
486,3/03/2023 11:00:00 am,Gila River Casino - Lone Butte,85226,NLH,65,46,19,0.7076923076923077,No Limit Hold'em
487,3/03/2023 11:15:00 am,Talking Stick Resort,85256,NLH,125,100,25,0.8,No-Limit Hold'em
488,3/03/2023 7:15:00 pm,Talking Stick Resort,85256,NLH,200,160,40,0.8,No Limit Hold'em
489,3/04/2023 11:00:00 am,Gila River Casino - Lone Butte,85226,NLH,235,200,35,0.851063829787234,No Limit Hold'em Bounty
490,3/04/2023 11:15:00 am,Talking Stick Resort,85256,NLH,345,300,45,0.8695652173913043,Big Stack No Limit Hold'em
491,3/04/2023 7:00:00 pm,Hon-Dah Casino,85935,NLH,30,20,10,0.6666666666666666,No Limit Hold'em
492,3/05/2023 11:00:00 am,Gila River Casino - Lone Butte,85226,NLH,125,100,25,0.8,No Limit Hold'em Sunday Brunch Tournament
493,3/05/2023 1:00:00 pm,Desert Diamond Casino,85305,NLH,60,50,10,0.8333333333333334,No Limit Hold'em Bounty
494,3/05/2023 7:00:00 pm,Hon-Dah Casino,85935,NLCRPI,30,20,10,0.6666666666666666,Crazy Pineapple Tournament
495,3/06/2023 10:00:00 am,Desert Diamond Casino,85305,NLH,40,35,5,0.875,No Limit Hold'em
496,3/06/2023 11:00:00 am,Gila River Casino - Lone Butte,85226,NLH,65,46,19,0.7076923076923077,No Limit Hold'em
497,3/06/2023 11:15:00 am,Talking Stick Resort,85256,NLH,125,100,25,0.8,No-Limit Hold'em
498,3/07/2023 11:00:00 am,Gila River Casino - Lone Butte,85226,NLH,65,46,19,0.7076923076923077,No Limit Hold'em
499,3/07/2023 11:15:00 am,Talking Stick Resort,85256,NLH,125,100,25,0.8,No-Limit Hold'em
500,3/07/2023 7:00:00 pm,Desert Diamond Casino,85305,NLH,60,55,5,0.9166666666666666,No Limit Hold'em
501,3/07/2023 7:00:00 pm,Hon-Dah Casino,85935,M,40,30,10,0.75,"Mix (Hold'em, Omaha 8, Crazy Pineapple)"
502,3/07/2023 7:15:00 pm,Talking Stick Resort,85256,NLH,200,160,40,0.8,No Limit Hold'em
503,3/08/2023 11:00:00 am,Gila River Casino - Lone Butte,85226,NLH,65,46,19,0.7076923076923077,No Limit Hold'em
504,3/08/2023 11:15:00 am,Talking Stick Resort,85256,NLH,125,100,25,0.8,No-Limit Hold'em
505,3/08/2023 7:00:00 pm,Hon-Dah Casino,85935,NLH,40,30,10,0.75,No Limit Hold'em
506,3/08/2023 7:00:00 pm,Desert Diamond Casino,85305,NLH,60,50,10,0.8333333333333334,No Limit Hold'em
507,3/08/2023 7:00:00 pm,Gila River Casino - Lone Butte,85226,NLH,105,80,25,0.7619047619047619,No Limit Hold'em
508,3/08/2023 7:15:00 pm,Talking Stick Resort,85256,NLH,145,115,30,0.7931034482758621,No Limit Hold'em
509,3/09/2023 10:00:00 am,Desert Diamond Casino,85305,NLH,40,35,5,0.875,No Limit Hold'em
510,3/09/2023 11:00:00 am,Gila River Casino - Lone Butte,85226,NLH,65,46,19,0.7076923076923077,No Limit Hold'em
511,3/09/2023 11:15:00 am,Talking Stick Resort,85256,NLH,125,100,25,0.8,No-Limit Hold'em
512,3/09/2023 7:00:00 pm,Hon-Dah Casino,85935,NLO8,40,30,10,0.75,Omaha 8/B
513,3/09/2023 7:00:00 pm,Gila River Casino - Lone Butte,85226,NLH,105,80,25,0.7619047619047619,No Limit Hold'em
514,3/09/2023 7:15:00 pm,Talking Stick Resort,85256,NLH,145,115,30,0.7931034482758621,No Limit Hold'em
515,3/10/2023 11:00:00 am,Gila River Casino - Lone Butte,85226,NLH,65,46,19,0.7076923076923077,No Limit Hold'em
516,3/10/2023 11:15:00 am,Talking Stick Resort,85256,NLH,125,100,25,0.8,No-Limit Hold'em
517,3/10/2023 7:15:00 pm,Talking Stick Resort,85256,NLH,200,160,40,0.8,No Limit Hold'em
518,3/11/2023 11:00:00 am,Gila River Casino - Lone Butte,85226,NLH,235,200,35,0.851063829787234,No Limit Hold'em Bounty
519,3/11/2023 7:00:00 pm,Hon-Dah Casino,85935,NLH,30,20,10,0.6666666666666666,No Limit Hold'em
520,3/12/2023 11:00:00 am,Gila River Casino - Lone Butte,85226,NLH,125,100,25,0.8,No Limit Hold'em Sunday Brunch Tournament
521,3/12/2023 1:00:00 pm,Desert Diamond Casino,85305,NLH,60,50,10,0.8333333333333334,No Limit Hold'em Bounty
522,3/12/2023 7:00:00 pm,Hon-Dah Casino,85935,NLCRPI,30,20,10,0.6666666666666666,Crazy Pineapple Tournament
523,3/13/2023 10:00:00 am,Desert Diamond Casino,85305,NLH,40,35,5,0.875,No Limit Hold'em
524,3/13/2023 11:00:00 am,Gila River Casino - Lone Butte,85226,NLH,65,46,19,0.7076923076923077,No Limit Hold'em
525,3/13/2023 11:15:00 am,Talking Stick Resort,85256,NLH,125,100,25,0.8,No-Limit Hold'em
526,3/14/2023 11:00:00 am,Gila River Casino - Lone Butte,85226,NLH,65,46,19,0.7076923076923077,No Limit Hold'em
527,3/14/2023 11:15:00 am,Talking Stick Resort,85256,NLH,125,100,25,0.8,No-Limit Hold'em
528,3/14/2023 7:00:00 pm,Desert Diamond Casino,85305,NLH,60,55,5,0.9166666666666666,No Limit Hold'em
529,3/14/2023 7:00:00 pm,Hon-Dah Casino,85935,M,40,30,10,0.75,"Mix (Hold'em, Omaha 8, Crazy Pineapple)"
530,3/14/2023 7:15:00 pm,Talking Stick Resort,85256,NLH,200,160,40,0.8,No Limit Hold'em
531,3/15/2023 11:00:00 am,Gila River Casino - Lone Butte,85226,NLH,65,46,19,0.7076923076923077,No Limit Hold'em
532,3/15/2023 11:15:00 am,Talking Stick Resort,85256,NLH,125,100,25,0.8,No-Limit Hold'em
533,1/14/2023 6:30:00 pm,Saracen Casino Resort,71601,NLH,240,200,40,0.8333333333333334,$240 buyin $100 Bounty
534,1/20/2023 6:30:00 pm,Saracen Casino Resort,71601,NLH,200,164,36,0.82,$200 buyin $ 50 bounty
535,1/21/2023 6:30:00 pm,Saracen Casino Resort,71601,NLH,240,200,40,0.8333333333333334,$240 buyin $100 Bounty
536,1/27/2023 6:30:00 pm,Saracen Casino Resort,71601,NLH,200,164,36,0.82,$200 buyin $ 50 bounty
537,1/28/2023 6:30:00 pm,Saracen Casino Resort,71601,NLH,240,200,40,0.8333333333333334,$240 buyin $100 Bounty
538,1/15/2023 12:10:00 pm,Horseshoe Casino Tunica,38676,NLH,100,72,28,0.72,"No-Limit Hold'em - Deep Stack ($3,000 Guaranteed)"
539,1/15/2023 7:10:00 pm,Horseshoe Casino Tunica,38676,NLH,35,35,ntry Fee $18 Staff Fee $15 Promo Fee $2,1.0,No-Limit Hold'em Stimulus
540,1/16/2023 12:10:00 pm,Horseshoe Casino Tunica,38676,NLH,65,42,23,0.6461538461538462,"No-Limit Hold'em ($1,000 Guaranteed)"
541,1/16/2023 7:10:00 pm,Horseshoe Casino Tunica,38676,NLH,75,48,27,0.64,"Monday Night Monster ($2,000 Guaranteed)"
542,1/17/2023 12:10:00 pm,Horseshoe Casino Tunica,38676,NLH,65,42,23,0.6461538461538462,"No-Limit Hold'em ($1,000 Guaranteed)"
543,1/17/2023 7:10:00 pm,Horseshoe Casino Tunica,38676,NLH,75,50,25,0.6666666666666666,"No-Limit Hold'em - Deepstack ($2,000 Guaranteed)"
544,1/18/2023 12:10:00 pm,Horseshoe Casino Tunica,38676,NLH,65,42,23,0.6461538461538462,"No-Limit Hold'em ($1,000 Guaranteed)"
545,1/18/2023 7:10:00 pm,Horseshoe Casino Tunica,38676,NLH,135,100,35,0.7407407407407407,"Big Monster ($4,000 Guaranteed)"
546,1/19/2023 11:00:00 am,Horseshoe Casino Tunica,38676,NLH,400,330,70,0.825,2022-23 WSOP Circuit Event (Tunica-Winter) - Event #1 - Big 30K Stack NLH
547,1/19/2023 4:00:00 pm,Horseshoe Casino Tunica,38676,NLH,400,330,70,0.825,2022-23 WSOP Circuit Event (Tunica-Winter) - Event #2 - NLH
548,1/20/2023 11:00:00 am,Horseshoe Casino Tunica,38676,NLH,400,330,70,0.825,2022-23 WSOP Circuit Event (Tunica-Winter) - Event #2 - NLH
549,1/20/2023 4:00:00 pm,Horseshoe Casino Tunica,38676,NLH,400,330,70,0.825,2022-23 WSOP Circuit Event (Tunica-Winter) - Event #2 - NLH
550,1/21/2023 11:00:00 am,Horseshoe Casino Tunica,38676,NLH,400,330,70,0.825,2022-23 WSOP Circuit Event (Tunica-Winter) - Event #2 - NLH
551,1/21/2023 4:00:00 pm,Horseshoe Casino Tunica,38676,NLH,400,330,70,0.825,2022-23 WSOP Circuit Event (Tunica-Winter) - Event #3 - NLH
552,1/22/2023 10:00:00 am,Horseshoe Casino Tunica,38676,NLH,300,240,60,0.8,2022-23 WSOP Circuit Event (Tunica-Winter) - Event #4 - NLH Seniors (50+)
553,1/22/2023 3:00:00 pm,Horseshoe Casino Tunica,38676,NLH,600,515,85,0.8583333333333333,2022-23 WSOP Circuit Event (Tunica-Winter) - Event #5 - NLH
554,1/23/2023 11:00:00 am,Horseshoe Casino Tunica,38676,NLH,400,330,70,0.825,2022-23 WSOP Circuit Event (Tunica-Winter) - Event #6 - 6-Max NLH
555,1/23/2023 4:00:00 pm,Horseshoe Casino Tunica,38676,PLO,400,330,70,0.825,2022-23 WSOP Circuit Event (Tunica-Winter) - Event #7 - PLO
556,1/24/2023 11:00:00 am,Horseshoe Casino Tunica,38676,NLH,400,330,70,0.825,2022-23 WSOP Circuit Event (Tunica-Winter) - Event #8 - Monster Stack NLH
557,1/25/2023 11:00:00 am,Horseshoe Casino Tunica,38676,NLH,400,330,70,0.825,2022-23 WSOP Circuit Event (Tunica-Winter) - Event #8 - Monster Stack NLH
558,1/26/2023 11:00:00 am,Horseshoe Casino Tunica,38676,NLH,1700,1515,185,0.8911764705882353,2022-23 WSOP Circuit Event (Tunica-Winter) - Event #9 - Main Event
559,1/26/2023 4:00:00 pm,Horseshoe Casino Tunica,38676,NLH,400,330,70,0.825,2022-23 WSOP Circuit Event (Tunica-Winter) - Event #10 - NLH
560,1/27/2023 11:00:00 am,Horseshoe Casino Tunica,38676,NLH,1700,1515,185,0.8911764705882353,2022-23 WSOP Circuit Event (Tunica-Winter) - Event #9 - Main Event
561,1/27/2023 4:00:00 pm,Horseshoe Casino Tunica,38676,NLH,400,330,70,0.825,2022-23 WSOP Circuit Event (Tunica-Winter) - Event #11 - NLH
562,1/28/2023 10:00:00 am,Horseshoe Casino Tunica,38676,NLH,200,160,40,0.8,2022-23 WSOP Circuit Event (Tunica-Winter) - Event #12 - NLH Ladies
563,1/28/2023 11:00:00 am,Horseshoe Casino Tunica,38676,NLH,1700,1515,185,0.8911764705882353,2022-23 WSOP Circuit Event (Tunica-Winter) - Event #9 - Main Event
564,1/28/2023 4:00:00 pm,Horseshoe Casino Tunica,38676,NLH,400,330,70,0.825,2022-23 WSOP Circuit Event (Tunica-Winter) - Event #13 - NLH
565,1/29/2023 10:00:00 am,Horseshoe Casino Tunica,38676,NLH,300,240,60,0.8,2022-23 WSOP Circuit Event (Tunica-Winter) - Event #14 - NLH Seniors (50+)
566,1/29/2023 3:00:00 pm,Horseshoe Casino Tunica,38676,NLH,600,515,85,0.8583333333333333,2022-23 WSOP Circuit Event (Tunica-Winter) - Event #15 - Black Chip Bounty NLH
567,1/30/2023 11:00:00 am,Horseshoe Casino Tunica,38676,NLH,400,330,70,0.825,2022-23 WSOP Circuit Event (Tunica-Winter) - Event #16 - Big 30K Stack NLH
568,1/31/2023 12:10:00 pm,Horseshoe Casino Tunica,38676,NLH,65,42,23,0.6461538461538462,"No-Limit Hold'em ($1,000 Guaranteed)"
569,1/31/2023 7:10:00 pm,Horseshoe Casino Tunica,38676,NLH,75,50,25,0.6666666666666666,"No-Limit Hold'em - Deepstack ($2,000 Guaranteed)"
570,2/01/2023 12:10:00 pm,Horseshoe Casino Tunica,38676,NLH,65,42,23,0.6461538461538462,"No-Limit Hold'em ($1,000 Guaranteed)"
571,2/01/2023 7:10:00 pm,Horseshoe Casino Tunica,38676,NLH,135,100,35,0.7407407407407407,"Big Monster ($4,000 Guaranteed)"
572,2/02/2023 12:10:00 pm,Horseshoe Casino Tunica,38676,NLH,65,42,23,0.6461538461538462,"No-Limit Hold'em ($1,000 Guaranteed)"
573,2/02/2023 7:10:00 pm,Horseshoe Casino Tunica,38676,NLH,100,72,28,0.72,No-Limit Hold'em - Green Chip Bonus - $400 in Bonus Bounties Added
574,2/03/2023 7:10:00 pm,Horseshoe Casino Tunica,38676,NLH,300,250,50,0.8333333333333334,"No-Limit Hold'em - $100 Bounty ($10,000 Guaranteed)"
575,2/05/2023 12:10:00 pm,Horseshoe Casino Tunica,38676,NLH,100,72,28,0.72,"No-Limit Hold'em - Deep Stack ($3,000 Guaranteed)"
576,2/05/2023 7:10:00 pm,Horseshoe Casino Tunica,38676,NLH,35,35,ntry Fee $18 Staff Fee $15 Promo Fee $2,1.0,No-Limit Hold'em Stimulus
577,2/06/2023 12:10:00 pm,Horseshoe Casino Tunica,38676,NLH,65,42,23,0.6461538461538462,"No-Limit Hold'em ($1,000 Guaranteed)"
578,2/06/2023 7:10:00 pm,Horseshoe Casino Tunica,38676,NLH,75,48,27,0.64,"Monday Night Monster ($2,000 Guaranteed)"
579,2/07/2023 12:10:00 pm,Horseshoe Casino Tunica,38676,NLH,65,42,23,0.6461538461538462,"No-Limit Hold'em ($1,000 Guaranteed)"
580,2/07/2023 7:10:00 pm,Horseshoe Casino Tunica,38676,NLH,75,50,25,0.6666666666666666,"No-Limit Hold'em - Deepstack ($2,000 Guaranteed)"
581,2/08/2023 12:10:00 pm,Horseshoe Casino Tunica,38676,NLH,65,42,23,0.6461538461538462,"No-Limit Hold'em ($1,000 Guaranteed)"
582,2/08/2023 7:10:00 pm,Horseshoe Casino Tunica,38676,NLH,135,100,35,0.7407407407407407,"Big Monster ($4,000 Guaranteed)"
583,2/09/2023 12:10:00 pm,Horseshoe Casino Tunica,38676,NLH,65,42,23,0.6461538461538462,"No-Limit Hold'em ($1,000 Guaranteed)"
584,2/09/2023 7:10:00 pm,Horseshoe Casino Tunica,38676,NLH,100,72,28,0.72,No-Limit Hold'em - Green Chip Bonus - $400 in Bonus Bounties Added
585,2/10/2023 7:10:00 pm,Horseshoe Casino Tunica,38676,NLH,300,250,50,0.8333333333333334,"No-Limit Hold'em - $100 Bounty ($10,000 Guaranteed)"
586,2/12/2023 12:10:00 pm,Horseshoe Casino Tunica,38676,NLH,100,72,28,0.72,"No-Limit Hold'em - Deep Stack ($3,000 Guaranteed)"
587,2/12/2023 7:10:00 pm,Horseshoe Casino Tunica,38676,NLH,35,35,ntry Fee $18 Staff Fee $15 Promo Fee $2,1.0,No-Limit Hold'em Stimulus
588,2/13/2023 12:10:00 pm,Horseshoe Casino Tunica,38676,NLH,65,42,23,0.6461538461538462,"No-Limit Hold'em ($1,000 Guaranteed)"
589,2/13/2023 7:10:00 pm,Horseshoe Casino Tunica,38676,NLH,75,48,27,0.64,"Monday Night Monster ($2,000 Guaranteed)"
590,2/14/2023 12:10:00 pm,Horseshoe Casino Tunica,38676,NLH,65,42,23,0.6461538461538462,"No-Limit Hold'em ($1,000 Guaranteed)"
591,2/14/2023 7:10:00 pm,Horseshoe Casino Tunica,38676,NLH,75,50,25,0.6666666666666666,"No-Limit Hold'em - Deepstack ($2,000 Guaranteed)"
592,2/15/2023 12:10:00 pm,Horseshoe Casino Tunica,38676,NLH,65,42,23,0.6461538461538462,"No-Limit Hold'em ($1,000 Guaranteed)"
593,2/15/2023 7:10:00 pm,Horseshoe Casino Tunica,38676,NLH,135,100,35,0.7407407407407407,"Big Monster ($4,000 Guaranteed)"
594,2/16/2023 12:10:00 pm,Horseshoe Casino Tunica,38676,NLH,65,42,23,0.6461538461538462,"No-Limit Hold'em ($1,000 Guaranteed)"
595,2/16/2023 7:10:00 pm,Horseshoe Casino Tunica,38676,NLH,100,72,28,0.72,No-Limit Hold'em - Green Chip Bonus - $400 in Bonus Bounties Added
596,2/17/2023 7:10:00 pm,Horseshoe Casino Tunica,38676,NLH,300,250,50,0.8333333333333334,"No-Limit Hold'em - $100 Bounty ($10,000 Guaranteed)"
597,2/19/2023 12:10:00 pm,Horseshoe Casino Tunica,38676,NLH,100,72,28,0.72,"No-Limit Hold'em - Deep Stack ($3,000 Guaranteed)"
598,2/19/2023 7:10:00 pm,Horseshoe Casino Tunica,38676,NLH,35,35,ntry Fee $18 Staff Fee $15 Promo Fee $2,1.0,No-Limit Hold'em Stimulus
599,2/20/2023 12:10:00 pm,Horseshoe Casino Tunica,38676,NLH,65,42,23,0.6461538461538462,"No-Limit Hold'em ($1,000 Guaranteed)"
600,2/20/2023 7:10:00 pm,Horseshoe Casino Tunica,38676,NLH,75,48,27,0.64,"Monday Night Monster ($2,000 Guaranteed)"
601,2/21/2023 12:10:00 pm,Horseshoe Casino Tunica,38676,NLH,65,42,23,0.6461538461538462,"No-Limit Hold'em ($1,000 Guaranteed)"
602,2/21/2023 7:10:00 pm,Horseshoe Casino Tunica,38676,NLH,75,50,25,0.6666666666666666,"No-Limit Hold'em - Deepstack ($2,000 Guaranteed)"
603,2/22/2023 12:10:00 pm,Horseshoe Casino Tunica,38676,NLH,65,42,23,0.6461538461538462,"No-Limit Hold'em ($1,000 Guaranteed)"
604,2/22/2023 7:10:00 pm,Horseshoe Casino Tunica,38676,NLH,135,100,35,0.7407407407407407,"Big Monster ($4,000 Guaranteed)"
605,2/23/2023 12:10:00 pm,Horseshoe Casino Tunica,38676,NLH,65,42,23,0.6461538461538462,"No-Limit Hold'em ($1,000 Guaranteed)"
606,2/23/2023 7:10:00 pm,Horseshoe Casino Tunica,38676,NLH,100,72,28,0.72,No-Limit Hold'em - Green Chip Bonus - $400 in Bonus Bounties Added
607,2/24/2023 7:10:00 pm,Horseshoe Casino Tunica,38676,NLH,300,250,50,0.8333333333333334,"No-Limit Hold'em - $100 Bounty ($10,000 Guaranteed)"
608,2/26/2023 12:10:00 pm,Horseshoe Casino Tunica,38676,NLH,100,72,28,0.72,"No-Limit Hold'em - Deep Stack ($3,000 Guaranteed)"
609,2/26/2023 7:10:00 pm,Horseshoe Casino Tunica,38676,NLH,35,35,ntry Fee $18 Staff Fee $15 Promo Fee $2,1.0,No-Limit Hold'em Stimulus
610,2/27/2023 12:10:00 pm,Horseshoe Casino Tunica,38676,NLH,65,42,23,0.6461538461538462,"No-Limit Hold'em ($1,000 Guaranteed)"
611,2/27/2023 7:10:00 pm,Horseshoe Casino Tunica,38676,NLH,75,48,27,0.64,"Monday Night Monster ($2,000 Guaranteed)"
612,2/28/2023 12:10:00 pm,Horseshoe Casino Tunica,38676,NLH,65,42,23,0.6461538461538462,"No-Limit Hold'em ($1,000 Guaranteed)"
613,2/28/2023 7:10:00 pm,Horseshoe Casino Tunica,38676,NLH,75,50,25,0.6666666666666666,"No-Limit Hold'em - Deepstack ($2,000 Guaranteed)"
614,3/01/2023 12:10:00 pm,Horseshoe Casino Tunica,38676,NLH,65,42,23,0.6461538461538462,"No-Limit Hold'em ($1,000 Guaranteed)"
615,3/01/2023 7:10:00 pm,Horseshoe Casino Tunica,38676,NLH,135,100,35,0.7407407407407407,"Big Monster ($4,000 Guaranteed)"
616,3/02/2023 12:10:00 pm,Horseshoe Casino Tunica,38676,NLH,65,42,23,0.6461538461538462,"No-Limit Hold'em ($1,000 Guaranteed)"
617,3/02/2023 7:10:00 pm,Horseshoe Casino Tunica,38676,NLH,100,72,28,0.72,No-Limit Hold'em - Green Chip Bonus - $400 in Bonus Bounties Added
618,3/03/2023 7:10:00 pm,Horseshoe Casino Tunica,38676,NLH,300,250,50,0.8333333333333334,"No-Limit Hold'em - $100 Bounty ($10,000 Guaranteed)"
619,3/05/2023 12:10:00 pm,Horseshoe Casino Tunica,38676,NLH,100,72,28,0.72,"No-Limit Hold'em - Deep Stack ($3,000 Guaranteed)"
620,3/05/2023 7:10:00 pm,Horseshoe Casino Tunica,38676,NLH,35,35,ntry Fee $18 Staff Fee $15 Promo Fee $2,1.0,No-Limit Hold'em Stimulus
621,3/06/2023 12:10:00 pm,Horseshoe Casino Tunica,38676,NLH,65,42,23,0.6461538461538462,"No-Limit Hold'em ($1,000 Guaranteed)"
622,3/06/2023 7:10:00 pm,Horseshoe Casino Tunica,38676,NLH,75,48,27,0.64,"Monday Night Monster ($2,000 Guaranteed)"
623,3/07/2023 12:10:00 pm,Horseshoe Casino Tunica,38676,NLH,65,42,23,0.6461538461538462,"No-Limit Hold'em ($1,000 Guaranteed)"
624,3/07/2023 7:10:00 pm,Horseshoe Casino Tunica,38676,NLH,75,50,25,0.6666666666666666,"No-Limit Hold'em - Deepstack ($2,000 Guaranteed)"
625,3/08/2023 12:10:00 pm,Horseshoe Casino Tunica,38676,NLH,65,42,23,0.6461538461538462,"No-Limit Hold'em ($1,000 Guaranteed)"
626,3/08/2023 7:10:00 pm,Horseshoe Casino Tunica,38676,NLH,135,100,35,0.7407407407407407,"Big Monster ($4,000 Guaranteed)"
627,3/09/2023 12:10:00 pm,Horseshoe Casino Tunica,38676,NLH,65,42,23,0.6461538461538462,"No-Limit Hold'em ($1,000 Guaranteed)"
628,3/09/2023 7:10:00 pm,Horseshoe Casino Tunica,38676,NLH,100,72,28,0.72,No-Limit Hold'em - Green Chip Bonus - $400 in Bonus Bounties Added
629,3/10/2023 7:10:00 pm,Horseshoe Casino Tunica,38676,NLH,300,250,50,0.8333333333333334,"No-Limit Hold'em - $100 Bounty ($10,000 Guaranteed)"
630,3/14/2023 12:10:00 pm,Horseshoe Casino Tunica,38676,NLH,65,42,23,0.6461538461538462,"No-Limit Hold'em ($1,000 Guaranteed)"
631,3/14/2023 7:10:00 pm,Horseshoe Casino Tunica,38676,NLH,75,50,25,0.6666666666666666,"No-Limit Hold'em - Deepstack ($2,000 Guaranteed)"
632,3/15/2023 12:10:00 pm,Horseshoe Casino Tunica,38676,NLH,65,42,23,0.6461538461538462,"No-Limit Hold'em ($1,000 Guaranteed)"
633,1/14/2023 12:15:00 pm,Chumash Casino,93460,NLH,120,97,23,0.8083333333333333,NLH
634,1/14/2023 3:30:00 pm,Oceanview Casino,95060,NLH,90,73,17,0.8111111111111111,Saturday $90
635,1/15/2023 3:30:00 pm,Oceanview Casino,95060,NLH,130,113,17,0.8692307692307693,sunday $130
636,1/17/2023 5:00:00 pm,Oceanview Casino,95060,NLH,50,33,17,0.66,Tuesday $50 Rebuy
637,1/18/2023 6:00:00 pm,Outlaws Card Parlour,93422,NLH,20,2,18,0.1,Wednesday $20
638,1/18/2023 7:00:00 pm,Garlic City Casino,95020,NLH,150,125,25,0.8333333333333334,NLH
639,1/19/2023 7:00:00 pm,Chumash Casino,93460,NLH,40,32,8,0.8,NLH
640,1/21/2023 12:15:00 pm,Chumash Casino,93460,NLH,120,97,23,0.8083333333333333,NLH
641,1/21/2023 3:30:00 pm,Oceanview Casino,95060,NLH,90,73,17,0.8111111111111111,Saturday $90
642,1/22/2023 3:30:00 pm,Oceanview Casino,95060,NLH,130,113,17,0.8692307692307693,sunday $130
643,1/24/2023 5:00:00 pm,Oceanview Casino,95060,NLH,50,33,17,0.66,Tuesday $50 Rebuy
644,1/25/2023 6:00:00 pm,Outlaws Card Parlour,93422,NLH,20,2,18,0.1,Wednesday $20
645,1/25/2023 7:00:00 pm,Garlic City Casino,95020,NLH,150,125,25,0.8333333333333334,NLH
646,1/26/2023 7:00:00 pm,Chumash Casino,93460,NLH,40,32,8,0.8,NLH
647,1/28/2023 12:15:00 pm,Chumash Casino,93460,NLH,120,97,23,0.8083333333333333,NLH
648,1/28/2023 3:30:00 pm,Oceanview Casino,95060,NLH,90,73,17,0.8111111111111111,Saturday $90
649,1/29/2023 3:30:00 pm,Oceanview Casino,95060,NLH,130,113,17,0.8692307692307693,sunday $130
650,1/31/2023 5:00:00 pm,Oceanview Casino,95060,NLH,50,33,17,0.66,tuesday $50 Rebuy
651,2/01/2023 6:00:00 pm,Outlaws Card Parlour,93422,NLH,20,2,18,0.1,Wednesday $20
652,2/01/2023 7:00:00 pm,Garlic City Casino,95020,NLH,150,125,25,0.8333333333333334,NLH
653,2/02/2023 7:00:00 pm,Chumash Casino,93460,NLH,40,32,8,0.8,NLH
654,2/04/2023 12:15:00 pm,Chumash Casino,93460,NLH,120,97,23,0.8083333333333333,NLH
655,2/04/2023 3:30:00 pm,Oceanview Casino,95060,NLH,130,113,17,0.8692307692307693,FIRST SATURDAY
656,2/04/2023 5:00:00 pm,Outlaws Card Parlour,93422,NLH,75,40,35,0.5333333333333333,1st Saturday Re-Buy
657,2/05/2023 3:30:00 pm,Oceanview Casino,95060,NLH,200,183,17,0.915,FIRST SUNDAY
658,2/07/2023 5:00:00 pm,Oceanview Casino,95060,NLH,70,53,17,0.7571428571428571,FIRST TUESDAY
659,2/08/2023 6:00:00 pm,Outlaws Card Parlour,93422,NLH,20,2,18,0.1,Wednesday $20
660,2/08/2023 7:00:00 pm,Garlic City Casino,95020,NLH,150,125,25,0.8333333333333334,NLH
661,2/09/2023 7:00:00 pm,Chumash Casino,93460,NLH,40,32,8,0.8,NLH
662,2/11/2023 12:15:00 pm,Chumash Casino,93460,NLH,120,97,23,0.8083333333333333,NLH
663,2/15/2023 6:00:00 pm,Outlaws Card Parlour,93422,NLH,20,2,18,0.1,Wednesday $20
664,2/15/2023 7:00:00 pm,Garlic City Casino,95020,NLH,150,125,25,0.8333333333333334,NLH
665,2/16/2023 7:00:00 pm,Chumash Casino,93460,NLH,40,32,8,0.8,NLH
666,2/18/2023 12:15:00 pm,Chumash Casino,93460,NLH,120,97,23,0.8083333333333333,NLH
667,2/22/2023 6:00:00 pm,Outlaws Card Parlour,93422,NLH,20,2,18,0.1,Wednesday $20
668,2/22/2023 7:00:00 pm,Garlic City Casino,95020,NLH,150,125,25,0.8333333333333334,NLH
669,2/23/2023 7:00:00 pm,Chumash Casino,93460,NLH,40,32,8,0.8,NLH
670,2/25/2023 12:15:00 pm,Chumash Casino,93460,NLH,120,97,23,0.8083333333333333,NLH
671,3/01/2023 7:00:00 pm,Garlic City Casino,95020,NLH,150,125,25,0.8333333333333334,NLH
672,3/02/2023 7:00:00 pm,Chumash Casino,93460,NLH,40,32,8,0.8,NLH
673,3/04/2023 12:15:00 pm,Chumash Casino,93460,NLH,120,97,23,0.8083333333333333,NLH
674,3/04/2023 5:00:00 pm,Outlaws Card Parlour,93422,NLH,75,40,35,0.5333333333333333,1st Saturday Re-Buy
675,3/08/2023 7:00:00 pm,Garlic City Casino,95020,NLH,150,125,25,0.8333333333333334,NLH
676,3/09/2023 7:00:00 pm,Chumash Casino,93460,NLH,40,32,8,0.8,NLH
677,3/11/2023 12:15:00 pm,Chumash Casino,93460,NLH,120,97,23,0.8083333333333333,NLH
678,1/14/2023 9:00:00 am,Parkwest Casino Manteca,95336,NLH,120,105,15,0.875,SATURDAY
679,1/14/2023 10:15:00 am,Club One Casino,93726,FLO8,40,32,8,0.8,"Saturday Morning Omaha 8+ $1,500 GTD"
680,1/14/2023 12:15:00 pm,Golden West Casino,93307,NLH,90,70,20,0.7777777777777778,Saturday $90 NLH
681,1/15/2023 9:00:00 am,Parkwest Casino Manteca,95336,NLH,120,105,15,0.875,SUNDAY
682,1/15/2023 12:15:00 pm,Club One Casino,93726,NLH,100,80,20,0.8,"Sunday High Roller $7,500 GTD"
683,1/16/2023 9:00:00 am,Parkwest Casino Manteca,95336,NLH,59,59,0,1.0,MONDAY
684,1/16/2023 10:15:00 am,Club One Casino,93726,NLH,50,40,10,0.8,"Monday Madness $1,000 GTD"
685,1/16/2023 6:15:00 pm,Club One Casino,93726,NLH,75,60,15,0.8,Winter Deep Freeze Satellite
686,1/17/2023 9:00:00 am,Parkwest Casino Manteca,95336,NLH,59,59,0,1.0,TUESDAY
687,1/17/2023 10:15:00 am,Club One Casino,93726,NLH,75,60,15,0.8,Winter Deep Freeze Satellite
688,1/17/2023 6:15:00 pm,Club One Casino,93726,NLH,80,65,15,0.8125,"Tuesday Nights W/Ted $3,000 GTD"
689,1/18/2023 9:00:00 am,Parkwest Casino Manteca,95336,NLH,59,59,0,1.0,WEDNESDAY
690,1/18/2023 10:15:00 am,Club One Casino,93726,NLH,40,32,8,0.8,Wednesday Morning Re-Buy
691,1/18/2023 6:15:00 pm,Club One Casino,93726,NLH,75,60,15,0.8,Winter Deep Freeze Satellite
692,1/18/2023 6:15:00 pm,Golden West Casino,93307,NLH,80,60,20,0.75,Wednesday $80
693,1/19/2023 9:00:00 am,Parkwest Casino Manteca,95336,NLH,59,59,0,1.0,THURSDAY
694,1/19/2023 10:15:00 am,Club One Casino,93726,NLH,75,60,15,0.8,Winter Deep Freeze Satellite
695,1/19/2023 4:15:00 pm,Club One Casino,93726,NLH,300,250,50,0.8333333333333334,Winter Deep Freeze $60K GTD Day 1a
696,1/20/2023 9:00:00 am,Parkwest Casino Manteca,95336,NLH,59,59,0,1.0,FRIDAY
697,1/20/2023 10:15:00 am,Club One Casino,93726,NLH,75,60,15,0.8,Winter Deep Freeze Satellite
698,1/20/2023 4:15:00 pm,Club One Casino,93726,NLH,300,250,50,0.8333333333333334,Winter Deep Freeze $60K GTD Day 1b
699,1/21/2023 9:00:00 am,Parkwest Casino Manteca,95336,NLH,120,105,15,0.875,SATURDAY
700,1/21/2023 12:05:00 pm,Golden West Casino,93307,NLH,90,70,20,0.7777777777777778,Saturday $90 NLH
701,1/21/2023 12:15:00 pm,Club One Casino,93726,NLH,300,250,50,0.8333333333333334,Winter Deep Freeze $60K GTD Day 1c
702,1/22/2023 9:00:00 am,Parkwest Casino Manteca,95336,NLH,120,105,15,0.875,SUNDAY
703,1/22/2023 11:15:00 am,Club One Casino,93726,NLH,0,0,0,1.1,Winter Deep Freeze 60K GTD Day 2
704,1/22/2023 1:15:00 pm,Club One Casino,93726,NLH,100,80,20,0.8,"Sunday High Roller $7,500 GTD"
705,1/25/2023 6:15:00 pm,Golden West Casino,93307,NLH,80,60,20,0.75,Wednesday $80
706,1/28/2023 12:05:00 pm,Golden West Casino,93307,NLH,90,70,20,0.7777777777777778,Saturday $90 NLH
707,1/14/2023 10:00:00 am,Agua Caliente Casino,92270,NLH,150,120,30,0.8,No-Limit Hold'em w/ $60 Rebuys
708,1/15/2023 10:00:00 am,Agua Caliente Casino,92270,NLH,150,120,30,0.8,No-Limit Hold'em w/ $60 Rebuys
709,1/16/2023 9:00:00 am,Agua Caliente Casino,92270,NLH,100,80,20,0.8,No-Limit Hold'em w/ $50 Rebuys
710,1/17/2023 9:00:00 am,Agua Caliente Casino,92270,NLH,100,80,20,0.8,No-Limit Hold'em w/ $50 Rebuys
711,1/17/2023 6:30:00 pm,Agua Caliente Casino,92270,NLH,120,90,30,0.75,No-Limit Hold'em w/ $50 Rebuys
712,1/18/2023 9:00:00 am,Agua Caliente Casino,92270,NLH,100,80,20,0.8,No-Limit Hold'em w/ $50 Rebuys
713,1/19/2023 9:00:00 am,Agua Caliente Casino,92270,NLH,100,80,20,0.8,No-Limit Hold'em w/ $50 Rebuys
714,1/19/2023 6:30:00 pm,Agua Caliente Casino,92270,NLH,120,90,30,0.75,No-Limit Hold'em w/ $50 Rebuys
715,1/20/2023 9:00:00 am,Agua Caliente Casino,92270,NLH,100,80,20,0.8,No-Limit Hold'em w/ $50 Rebuys
716,1/21/2023 10:00:00 am,Agua Caliente Casino,92270,NLH,150,120,30,0.8,No-Limit Hold'em w/ $60 Rebuys
717,1/22/2023 10:00:00 am,Agua Caliente Casino,92270,NLH,150,120,30,0.8,No-Limit Hold'em w/ $60 Rebuys
718,1/23/2023 9:00:00 am,Agua Caliente Casino,92270,NLH,100,80,20,0.8,No-Limit Hold'em w/ $50 Rebuys
719,1/24/2023 9:00:00 am,Agua Caliente Casino,92270,NLH,100,80,20,0.8,No-Limit Hold'em w/ $50 Rebuys
720,1/24/2023 6:30:00 pm,Agua Caliente Casino,92270,NLH,120,90,30,0.75,No-Limit Hold'em w/ $50 Rebuys
721,1/25/2023 9:00:00 am,Agua Caliente Casino,92270,NLH,100,80,20,0.8,No-Limit Hold'em w/ $50 Rebuys
722,1/26/2023 9:00:00 am,Agua Caliente Casino,92270,NLH,100,80,20,0.8,No-Limit Hold'em w/ $50 Rebuys
723,1/26/2023 6:30:00 pm,Agua Caliente Casino,92270,NLH,120,90,30,0.75,No-Limit Hold'em w/ $50 Rebuys
724,1/27/2023 9:00:00 am,Agua Caliente Casino,92270,NLH,100,80,20,0.8,No-Limit Hold'em w/ $50 Rebuys
725,1/28/2023 10:00:00 am,Agua Caliente Casino,92270,NLH,150,120,30,0.8,No-Limit Hold'em w/ $60 Rebuys
726,1/29/2023 10:00:00 am,Agua Caliente Casino,92270,NLH,150,120,30,0.8,No-Limit Hold'em w/ $60 Rebuys
727,1/30/2023 9:00:00 am,Agua Caliente Casino,92270,NLH,100,80,20,0.8,No-Limit Hold'em w/ $50 Rebuys
728,1/31/2023 9:00:00 am,Agua Caliente Casino,92270,NLH,100,80,20,0.8,No-Limit Hold'em w/ $50 Rebuys
729,1/31/2023 6:30:00 pm,Agua Caliente Casino,92270,NLH,120,90,30,0.75,No-Limit Hold'em w/ $50 Rebuys
730,2/01/2023 9:00:00 am,Agua Caliente Casino,92270,NLH,100,80,20,0.8,No-Limit Hold'em w/ $50 Rebuys
731,2/02/2023 9:00:00 am,Agua Caliente Casino,92270,NLH,100,80,20,0.8,No-Limit Hold'em w/ $50 Rebuys
732,2/02/2023 6:30:00 pm,Agua Caliente Casino,92270,NLH,120,90,30,0.75,No-Limit Hold'em w/ $50 Rebuys
733,2/04/2023 10:00:00 am,Agua Caliente Casino,92270,NLH,150,120,30,0.8,No-Limit Hold'em w/ $60 Rebuys
734,2/05/2023 10:00:00 am,Agua Caliente Casino,92270,NLH,150,120,30,0.8,No-Limit Hold'em w/ $60 Rebuys
735,2/06/2023 9:00:00 am,Agua Caliente Casino,92270,NLH,100,80,20,0.8,No-Limit Hold'em w/ $50 Rebuys
736,2/07/2023 9:00:00 am,Agua Caliente Casino,92270,NLH,100,80,20,0.8,No-Limit Hold'em w/ $50 Rebuys
737,2/07/2023 6:30:00 pm,Agua Caliente Casino,92270,NLH,120,90,30,0.75,No-Limit Hold'em w/ $50 Rebuys
738,2/08/2023 9:00:00 am,Agua Caliente Casino,92270,NLH,100,80,20,0.8,No-Limit Hold'em w/ $50 Rebuys
739,2/09/2023 9:00:00 am,Agua Caliente Casino,92270,NLH,100,80,20,0.8,No-Limit Hold'em w/ $50 Rebuys
740,2/09/2023 6:30:00 pm,Agua Caliente Casino,92270,NLH,120,90,30,0.75,No-Limit Hold'em w/ $50 Rebuys
741,2/10/2023 9:00:00 am,Agua Caliente Casino,92270,NLH,100,80,20,0.8,No-Limit Hold'em w/ $50 Rebuys
742,2/11/2023 10:00:00 am,Agua Caliente Casino,92270,NLH,150,120,30,0.8,No-Limit Hold'em w/ $60 Rebuys
743,2/12/2023 10:00:00 am,Agua Caliente Casino,92270,NLH,150,120,30,0.8,No-Limit Hold'em w/ $60 Rebuys
744,2/13/2023 9:00:00 am,Agua Caliente Casino,92270,NLH,100,80,20,0.8,No-Limit Hold'em w/ $50 Rebuys
745,2/14/2023 9:00:00 am,Agua Caliente Casino,92270,NLH,100,80,20,0.8,No-Limit Hold'em w/ $50 Rebuys
746,2/14/2023 6:30:00 pm,Agua Caliente Casino,92270,NLH,120,90,30,0.75,No-Limit Hold'em w/ $50 Rebuys
747,2/15/2023 9:00:00 am,Agua Caliente Casino,92270,NLH,100,80,20,0.8,No-Limit Hold'em w/ $50 Rebuys
748,2/16/2023 9:00:00 am,Agua Caliente Casino,92270,NLH,100,80,20,0.8,No-Limit Hold'em w/ $50 Rebuys
749,2/16/2023 6:30:00 pm,Agua Caliente Casino,92270,NLH,120,90,30,0.75,No-Limit Hold'em w/ $50 Rebuys
750,2/17/2023 9:00:00 am,Agua Caliente Casino,92270,NLH,100,80,20,0.8,No-Limit Hold'em w/ $50 Rebuys
751,2/18/2023 10:00:00 am,Agua Caliente Casino,92270,NLH,150,120,30,0.8,No-Limit Hold'em w/ $60 Rebuys
752,2/19/2023 10:00:00 am,Agua Caliente Casino,92270,NLH,150,120,30,0.8,No-Limit Hold'em w/ $60 Rebuys
753,2/20/2023 9:00:00 am,Agua Caliente Casino,92270,NLH,100,80,20,0.8,No-Limit Hold'em w/ $50 Rebuys
754,2/21/2023 9:00:00 am,Agua Caliente Casino,92270,NLH,100,80,20,0.8,No-Limit Hold'em w/ $50 Rebuys
755,2/21/2023 6:30:00 pm,Agua Caliente Casino,92270,NLH,120,90,30,0.75,No-Limit Hold'em w/ $50 Rebuys
756,2/22/2023 9:00:00 am,Agua Caliente Casino,92270,NLH,100,80,20,0.8,No-Limit Hold'em w/ $50 Rebuys
757,2/23/2023 9:00:00 am,Agua Caliente Casino,92270,NLH,100,80,20,0.8,No-Limit Hold'em w/ $50 Rebuys
758,2/23/2023 6:30:00 pm,Agua Caliente Casino,92270,NLH,120,90,30,0.75,No-Limit Hold'em w/ $50 Rebuys
759,2/24/2023 9:00:00 am,Agua Caliente Casino,92270,NLH,100,80,20,0.8,No-Limit Hold'em w/ $50 Rebuys
760,2/25/2023 10:00:00 am,Agua Caliente Casino,92270,NLH,150,120,30,0.8,No-Limit Hold'em w/ $60 Rebuys
761,2/26/2023 10:00:00 am,Agua Caliente Casino,92270,NLH,150,120,30,0.8,No-Limit Hold'em w/ $60 Rebuys
762,2/27/2023 9:00:00 am,Agua Caliente Casino,92270,NLH,100,80,20,0.8,No-Limit Hold'em w/ $50 Rebuys
763,2/28/2023 9:00:00 am,Agua Caliente Casino,92270,NLH,100,80,20,0.8,No-Limit Hold'em w/ $50 Rebuys
764,2/28/2023 6:30:00 pm,Agua Caliente Casino,92270,NLH,120,90,30,0.75,No-Limit Hold'em w/ $50 Rebuys
765,3/01/2023 9:00:00 am,Agua Caliente Casino,92270,NLH,100,80,20,0.8,No-Limit Hold'em w/ $50 Rebuys
766,3/02/2023 9:00:00 am,Agua Caliente Casino,92270,NLH,100,80,20,0.8,No-Limit Hold'em w/ $50 Rebuys
767,3/02/2023 6:30:00 pm,Agua Caliente Casino,92270,NLH,120,90,30,0.75,No-Limit Hold'em w/ $50 Rebuys
768,3/03/2023 9:00:00 am,Agua Caliente Casino,92270,NLH,100,80,20,0.8,No-Limit Hold'em w/ $50 Rebuys
769,3/04/2023 10:00:00 am,Agua Caliente Casino,92270,NLH,150,120,30,0.8,No-Limit Hold'em w/ $60 Rebuys
770,3/05/2023 10:00:00 am,Agua Caliente Casino,92270,NLH,150,120,30,0.8,No-Limit Hold'em w/ $60 Rebuys
771,3/06/2023 9:00:00 am,Agua Caliente Casino,92270,NLH,100,80,20,0.8,No-Limit Hold'em w/ $50 Rebuys
772,3/07/2023 9:00:00 am,Agua Caliente Casino,92270,NLH,100,80,20,0.8,No-Limit Hold'em w/ $50 Rebuys
773,3/07/2023 6:30:00 pm,Agua Caliente Casino,92270,NLH,120,90,30,0.75,No-Limit Hold'em w/ $50 Rebuys
774,3/08/2023 9:00:00 am,Agua Caliente Casino,92270,NLH,100,80,20,0.8,No-Limit Hold'em w/ $50 Rebuys
775,3/09/2023 9:00:00 am,Agua Caliente Casino,92270,NLH,100,80,20,0.8,No-Limit Hold'em w/ $50 Rebuys
776,3/09/2023 6:30:00 pm,Agua Caliente Casino,92270,NLH,120,90,30,0.75,No-Limit Hold'em w/ $50 Rebuys
777,3/10/2023 9:00:00 am,Agua Caliente Casino,92270,NLH,100,80,20,0.8,No-Limit Hold'em w/ $50 Rebuys
778,3/11/2023 10:00:00 am,Agua Caliente Casino,92270,NLH,150,120,30,0.8,No-Limit Hold'em w/ $60 Rebuys
779,3/12/2023 10:00:00 am,Agua Caliente Casino,92270,NLH,150,120,30,0.8,No-Limit Hold'em w/ $60 Rebuys
780,3/13/2023 9:00:00 am,Agua Caliente Casino,92270,NLH,100,80,20,0.8,No-Limit Hold'em w/ $50 Rebuys
781,3/14/2023 9:00:00 am,Agua Caliente Casino,92270,NLH,100,80,20,0.8,No-Limit Hold'em w/ $50 Rebuys
782,3/14/2023 6:30:00 pm,Agua Caliente Casino,92270,NLH,120,90,30,0.75,No-Limit Hold'em w/ $50 Rebuys
783,3/15/2023 9:00:00 am,Agua Caliente Casino,92270,NLH,100,80,20,0.8,No-Limit Hold'em w/ $50 Rebuys
784,1/14/2023 10:00:00 am,Hollywood Park Casino,90303,NLH,100,67,33,0.67,"No-Limit Hold'em ($10,000 Guaranteed)"
785,1/14/2023 11:00:00 am,Commerce Casino,90040,NLH,250,200,50,0.8,LA Poker Classic 2023 - Event #1 - NLH Big 50
786,1/14/2023 11:30:00 am,The Gardens Casino,90716,NLH,250,210,40,0.84,$25K NLH
787,1/14/2023 1:00:00 pm,Larry Flynt's Lucky Lady Casino,90247,NLH,75,55,20,0.7333333333333333,$2000 guarantee
788,1/14/2023 2:15:00 pm,The Gardens Casino,90716,NLH,125,100,25,0.8,Sit-N-Go
789,1/14/2023 3:00:00 pm,Hustler Casino,90247,NLH,80,50,30,0.625,"SATURDAY $2,000 GTD"
790,1/14/2023 4:00:00 pm,Commerce Casino,90040,NLH,250,200,50,0.8,LA Poker Classic 2023 - Event #1 - NLH Big 50
791,1/14/2023 4:00:00 pm,The Gardens Casino,90716,NLH,125,100,25,0.8,Sit-N-Go
792,1/14/2023 6:00:00 pm,The Gardens Casino,90716,NLH,125,100,25,0.8,Sit-N-Go
793,1/15/2023 11:00:00 am,Commerce Casino,90040,NLH,250,200,50,0.8,LA Poker Classic 2023 - Event #1 - NLH Big 50
794,1/15/2023 1:00:00 pm,Larry Flynt's Lucky Lady Casino,90247,NLH,125,100,25,0.8,$5000 guarantee
795,1/15/2023 3:00:00 pm,Hustler Casino,90247,NLH,100,70,30,0.7,"SUNDAY $3,000 GTD"
796,1/15/2023 4:00:00 pm,Commerce Casino,90040,NLH,250,200,50,0.8,LA Poker Classic 2023 - Event #1 - NLH Big 50
797,1/16/2023 10:00:00 am,Hollywood Park Casino,90303,NLH,250,187,63,0.748,MLK Jr. Day Special
798,1/16/2023 11:00:00 am,Commerce Casino,90040,O8/S8,400,330,70,0.825,LA Poker Classic 2023 - Event #2 - Omaha 8/Stud 8
799,1/16/2023 12:00:00 pm,Commerce Casino,90040,NLH,250,200,50,0.8,LA Poker Classic 2023 - Event #3 - NLH
800,1/16/2023 5:00:00 pm,Larry Flynt's Lucky Lady Casino,90247,NLH,80,60,20,0.75,$2000 bounty
801,1/16/2023 5:00:00 pm,Commerce Casino,90040,NLH,250,200,50,0.8,LA Poker Classic 2023 - Event #4 - NLH Bounty
802,1/17/2023 10:00:00 am,Hollywood Park Casino,90303,NLH,120,95,25,0.7916666666666666,"No-Limit Hold'em ($4,000 Guaranteed)"
803,1/17/2023 11:00:00 am,Commerce Casino,90040,FLTOE,400,330,70,0.825,LA Poker Classic 2023 - Event #5 - T.O.E.
804,1/17/2023 12:00:00 pm,Commerce Casino,90040,NLH,250,200,50,0.8,LA Poker Classic 2023 - Event #6 - NLH
805,1/17/2023 5:00:00 pm,Commerce Casino,90040,NLH,360,300,60,0.8333333333333334,LA Poker Classic 2023 - Event #7 - NLH Jacked Stack
806,1/17/2023 6:00:00 pm,Hollywood Park Casino,90303,NLH,100,67,33,0.67,"No-Limit Hold'em ($10,000 Guaranteed)"
807,1/18/2023 11:00:00 am,Commerce Casino,90040,ROSE,400,330,70,0.825,LA Poker Classic 2023 - Event #8 - R.O.S.E.
808,1/18/2023 11:30:00 am,The Gardens Casino,90716,NLH,130,100,30,0.7692307692307693,$10K NLH Bounty
809,1/18/2023 12:00:00 pm,Commerce Casino,90040,NLH,250,200,50,0.8,LA Poker Classic 2023 - Event #9 - NLH
810,1/18/2023 2:15:00 pm,The Gardens Casino,90716,NLH,125,100,25,0.8,Sit-N-Go
811,1/18/2023 4:00:00 pm,The Gardens Casino,90716,NLH,125,100,25,0.8,Sit-N-Go
812,1/18/2023 5:00:00 pm,Commerce Casino,90040,NLH,360,300,60,0.8333333333333334,LA Poker Classic 2023 - Event #7 - NLH Jacked Stack
813,1/18/2023 6:00:00 pm,Hollywood Park Casino,90303,NLH,100,67,33,0.67,"No-Limit Hold'em Bounty ($10,000 Guaranteed)"
814,1/18/2023 6:00:00 pm,The Gardens Casino,90716,NLH,125,100,25,0.8,Sit-N-Go
815,1/19/2023 11:00:00 am,Commerce Casino,90040,M,400,330,70,0.825,LA Poker Classic 2023 - Event #10 - B.E.A.S.T.
816,1/19/2023 11:30:00 am,The Gardens Casino,90716,NLH,130,100,30,0.7692307692307693,$10K NLH
817,1/19/2023 12:00:00 pm,Commerce Casino,90040,NLH,250,200,50,0.8,LA Poker Classic 2023 - Event #11 - NLH
818,1/19/2023 2:15:00 pm,The Gardens Casino,90716,NLH,125,100,25,0.8,Sit-N-Go
819,1/19/2023 4:00:00 pm,The Gardens Casino,90716,NLH,125,100,25,0.8,Sit-N-Go
820,1/19/2023 5:00:00 pm,Commerce Casino,90040,NLH,360,300,60,0.8333333333333334,LA Poker Classic 2023 - Event #7 - NLH Jacked Stack
821,1/19/2023 5:15:00 pm,Larry Flynt's Lucky Lady Casino,90247,O8/S8,80,60,20,0.75,$1000 guarantee E/O
822,1/19/2023 6:00:00 pm,Hollywood Park Casino,90303,NLH,100,67,33,0.67,"No-Limit Hold'em Bounty ($10,000 Guaranteed)"
823,1/19/2023 6:00:00 pm,The Gardens Casino,90716,NLH,125,100,25,0.8,Sit-N-Go
824,1/20/2023 10:00:00 am,Hollywood Park Casino,90303,NLH,200,154,46,0.77,"No-Limit Hold'em Bounty ($10,000 Guaranteed)"
825,1/20/2023 11:00:00 am,Commerce Casino,90040,M,400,330,70,0.825,LA Poker Classic 2023 - Event #12 - P.R.E.S.T.O.
826,1/20/2023 11:30:00 am,The Gardens Casino,90716,NLH,240,200,40,0.8333333333333334,$20K NLH
827,1/20/2023 12:00:00 pm,Commerce Casino,90040,NLH,360,300,60,0.8333333333333334,LA Poker Classic 2023 - Event #7 - NLH Jacked Stack
828,1/20/2023 2:15:00 pm,The Gardens Casino,90716,NLH,125,100,25,0.8,Sit-N-Go
829,1/20/2023 4:00:00 pm,The Gardens Casino,90716,NLH,125,100,25,0.8,Sit-N-Go
830,1/20/2023 5:00:00 pm,Larry Flynt's Lucky Lady Casino,90247,NLH,100,80,20,0.8,$5000 guarantee
831,1/20/2023 5:00:00 pm,Commerce Casino,90040,NLH,360,300,60,0.8333333333333334,LA Poker Classic 2023 - Event #7 - NLH Jacked Stack
832,1/20/2023 6:00:00 pm,The Gardens Casino,90716,NLH,125,100,25,0.8,Sit-N-Go
833,1/21/2023 10:00:00 am,Hollywood Park Casino,90303,NLH,100,67,33,0.67,"No-Limit Hold'em ($10,000 Guaranteed)"
834,1/21/2023 11:30:00 am,The Gardens Casino,90716,NLH,250,210,40,0.84,$25K NLH
835,1/21/2023 1:00:00 pm,Larry Flynt's Lucky Lady Casino,90247,NLH,75,55,20,0.7333333333333333,$2000 guarantee
836,1/21/2023 1:00:00 pm,Commerce Casino,90040,NLH,360,300,60,0.8333333333333334,LA Poker Classic 2023 - Event #13 - NLH Battle of the Ages
837,1/21/2023 2:15:00 pm,The Gardens Casino,90716,NLH,125,100,25,0.8,Sit-N-Go
838,1/21/2023 4:00:00 pm,The Gardens Casino,90716,NLH,125,100,25,0.8,Sit-N-Go
839,1/21/2023 6:00:00 pm,Commerce Casino,90040,NLH,250,200,50,0.8,LA Poker Classic 2023 - Event #14 - NLH 7 Hours and Times Up
840,1/21/2023 6:00:00 pm,The Gardens Casino,90716,NLH,125,100,25,0.8,Sit-N-Go
841,1/22/2023 10:00:00 am,Hollywood Park Casino,90303,NLH,200,157,43,0.785,NLH Sunday Sunrise Bounty
842,1/22/2023 12:00:00 pm,Commerce Casino,90040,NLH,360,300,60,0.8333333333333334,LA Poker Classic 2023 - Event #15 - NLH Bounty Multiplier
843,1/22/2023 1:00:00 pm,Larry Flynt's Lucky Lady Casino,90247,NLH,125,100,25,0.8,"Chinese New Year $8,888 guarantee"
844,1/22/2023 5:00:00 pm,Commerce Casino,90040,NLH,288,240,48,0.8333333333333334,LA Poker Classic 2023 - Event #16 - NLH Mystery Bounty
845,1/23/2023 10:00:00 am,Hollywood Park Casino,90303,NLH,120,95,25,0.7916666666666666,"No-Limit Hold'em ($4,000 Guaranteed)"
846,1/23/2023 11:00:00 am,Commerce Casino,90040,FLO8,400,330,70,0.825,LA Poker Classic 2023 - Event #17 - Omaha 8
847,1/23/2023 12:00:00 pm,Commerce Casino,90040,NLH,250,200,50,0.8,LA Poker Classic 2023 - Event #18 - NLH
848,1/23/2023 5:00:00 pm,Larry Flynt's Lucky Lady Casino,90247,NLH,80,60,20,0.75,$2000 bounty
849,1/23/2023 5:00:00 pm,Commerce Casino,90040,NLH,288,240,48,0.8333333333333334,LA Poker Classic 2023 - Event #16 - NLH Mystery Bounty
850,1/23/2023 6:00:00 pm,Hollywood Park Casino,90303,NLH,100,67,33,0.67,"No-Limit Hold'em ($10,000 Guaranteed)"
851,1/24/2023 10:00:00 am,Hollywood Park Casino,90303,NLH,120,95,25,0.7916666666666666,"No-Limit Hold'em ($4,000 Guaranteed)"
852,1/24/2023 11:00:00 am,Commerce Casino,90040,HORSE,400,330,70,0.825,LA Poker Classic 2023 - Event #19 - H.O.R.S.E.
853,1/24/2023 12:00:00 pm,Commerce Casino,90040,NLH,250,200,50,0.8,LA Poker Classic 2023 - Event #20 - NLH
854,1/24/2023 5:00:00 pm,Commerce Casino,90040,NLH,288,240,48,0.8333333333333334,LA Poker Classic 2023 - Event #16 - NLH Mystery Bounty
855,1/24/2023 6:00:00 pm,Hollywood Park Casino,90303,NLH,100,67,33,0.67,"No-Limit Hold'em ($10,000 Guaranteed)"
856,1/25/2023 11:00:00 am,Commerce Casino,90040,FLMTD,400,330,70,0.825,LA Poker Classic 2023 - Event #21 - Triple Triple Draw
857,1/25/2023 11:30:00 am,The Gardens Casino,90716,NLH,130,100,30,0.7692307692307693,$10K NLH Bounty
858,1/25/2023 12:00:00 pm,Commerce Casino,90040,NLH,250,200,50,0.8,LA Poker Classic 2023 - Event #22 - NLH
859,1/25/2023 2:15:00 pm,The Gardens Casino,90716,NLH,125,100,25,0.8,Sit-N-Go
860,1/25/2023 4:00:00 pm,The Gardens Casino,90716,NLH,125,100,25,0.8,Sit-N-Go
861,1/25/2023 5:00:00 pm,Commerce Casino,90040,NLH,288,240,48,0.8333333333333334,LA Poker Classic 2023 - Event #16 - NLH Mystery Bounty
862,1/25/2023 6:00:00 pm,Hollywood Park Casino,90303,NLH,100,67,33,0.67,"No-Limit Hold'em Bounty ($10,000 Guaranteed)"
863,1/25/2023 6:00:00 pm,The Gardens Casino,90716,NLH,125,100,25,0.8,Sit-N-Go
864,1/26/2023 11:00:00 am,Commerce Casino,90040,MLMO,400,330,70,0.825,LA Poker Classic 2023 - Event #23 - Mixed Omaha
865,1/26/2023 11:30:00 am,The Gardens Casino,90716,NLH,130,100,30,0.7692307692307693,$10K NLH
866,1/26/2023 12:00:00 pm,Commerce Casino,90040,NLH,250,200,50,0.8,LA Poker Classic 2023 - Event #24 - NLH
867,1/26/2023 2:15:00 pm,The Gardens Casino,90716,NLH,125,100,25,0.8,Sit-N-Go
868,1/26/2023 4:00:00 pm,The Gardens Casino,90716,NLH,125,100,25,0.8,Sit-N-Go
869,1/26/2023 5:00:00 pm,Larry Flynt's Lucky Lady Casino,90247,O8/S8,80,60,20,0.75,$1000 guarantee E/O
870,1/26/2023 5:00:00 pm,Commerce Casino,90040,NLH,288,240,48,0.8333333333333334,LA Poker Classic 2023 - Event #16 - NLH Mystery Bounty
871,1/26/2023 6:00:00 pm,Hollywood Park Casino,90303,NLH,100,67,33,0.67,"No-Limit Hold'em Bounty ($10,000 Guaranteed)"
872,1/26/2023 6:00:00 pm,The Gardens Casino,90716,NLH,125,100,25,0.8,Sit-N-Go
873,1/27/2023 10:00:00 am,Hollywood Park Casino,90303,NLH,200,154,46,0.77,"No-Limit Hold'em Bounty ($10,000 Guaranteed)"
874,1/27/2023 11:00:00 am,Commerce Casino,90040,NLH,288,240,48,0.8333333333333334,LA Poker Classic 2023 - Event #16 - NLH Mystery Bounty
875,1/27/2023 11:30:00 am,The Gardens Casino,90716,NLH,240,200,40,0.8333333333333334,$20K NLH
876,1/27/2023 2:15:00 pm,The Gardens Casino,90716,NLH,125,100,25,0.8,Sit-N-Go
877,1/27/2023 4:00:00 pm,The Gardens Casino,90716,NLH,125,100,25,0.8,Sit-N-Go
878,1/27/2023 4:00:00 pm,Commerce Casino,90040,NLH,288,240,48,0.8333333333333334,LA Poker Classic 2023 - Event #16 - NLH Mystery Bounty
879,1/27/2023 5:00:00 pm,Larry Flynt's Lucky Lady Casino,90247,NLH,100,80,20,0.8,$5000 guarantee
880,1/27/2023 6:00:00 pm,The Gardens Casino,90716,NLH,125,100,25,0.8,Sit-N-Go
881,1/28/2023 10:00:00 am,Hollywood Park Casino,90303,NLH,100,67,33,0.67,"No-Limit Hold'em ($10,000 Guaranteed)"
882,1/28/2023 11:00:00 am,Commerce Casino,90040,NLH,288,240,48,0.8333333333333334,LA Poker Classic 2023 - Event #16 - NLH Mystery Bounty
883,1/28/2023 11:30:00 am,The Gardens Casino,90716,NLH,250,210,40,0.84,$25K NLH
884,1/28/2023 1:00:00 pm,Larry Flynt's Lucky Lady Casino,90247,NLH,75,55,20,0.7333333333333333,$2000 guarantee
885,1/28/2023 2:15:00 pm,The Gardens Casino,90716,NLH,125,100,25,0.8,Sit-N-Go
886,1/28/2023 4:00:00 pm,The Gardens Casino,90716,NLH,125,100,25,0.8,Sit-N-Go
887,1/28/2023 4:00:00 pm,Commerce Casino,90040,NLH,288,240,48,0.8333333333333334,LA Poker Classic 2023 - Event #16 - NLH Mystery Bounty
888,1/28/2023 6:00:00 pm,The Gardens Casino,90716,NLH,125,100,25,0.8,Sit-N-Go
889,1/29/2023 10:00:00 am,Hollywood Park Casino,90303,NLH,300,237,63,0.79,NLH Sunday Special
890,1/29/2023 11:00:00 am,Commerce Casino,90040,FLH,600,510,90,0.85,LA Poker Classic 2023 - Event #25 - Limit Hold'em Mixed Game Championship
891,1/29/2023 12:00:00 pm,Commerce Casino,90040,NLH,360,300,60,0.8333333333333334,LA Poker Classic 2023 - Event #26 - NLH
892,1/29/2023 1:00:00 pm,Larry Flynt's Lucky Lady Casino,90247,NLH,125,100,25,0.8,$5000 guarantee
893,1/29/2023 5:00:00 pm,Commerce Casino,90040,NLH,200,170,30,0.85,LA Poker Classic 2023 - Event #27 - NLH Turbo
894,1/30/2023 10:00:00 am,Hollywood Park Casino,90303,NLH,120,95,25,0.7916666666666666,"No-Limit Hold'em ($4,000 Guaranteed)"
895,1/30/2023 11:00:00 am,Commerce Casino,90040,FLO8,600,510,90,0.85,LA Poker Classic 2023 - Event #28 - Omaha 8 Mixed Game Championship
896,1/30/2023 12:00:00 pm,Commerce Casino,90040,NLH,250,200,50,0.8,LA Poker Classic 2023 - Event #29 - NLH
897,1/30/2023 5:00:00 pm,Larry Flynt's Lucky Lady Casino,90247,NLH,80,60,20,0.75,$2000 bounty
898,1/30/2023 5:00:00 pm,Commerce Casino,90040,NLH,360,300,60,0.8333333333333334,LA Poker Classic 2023 - Event #30 - NLH 30th Anniversary
899,1/30/2023 6:00:00 pm,Hollywood Park Casino,90303,NLH,100,67,33,0.67,"No-Limit Hold'em ($10,000 Guaranteed)"
900,1/31/2023 10:00:00 am,Hollywood Park Casino,90303,NLH,120,95,25,0.7916666666666666,"No-Limit Hold'em ($4,000 Guaranteed)"
901,1/31/2023 11:00:00 am,Commerce Casino,90040,Razz,600,510,90,0.85,LA Poker Classic 2023 - Event #31 - Razz Mixed Game Championship
902,1/31/2023 12:00:00 pm,Commerce Casino,90040,NLH,250,200,50,0.8,LA Poker Classic 2023 - Event #32 - NLH
903,1/31/2023 5:00:00 pm,Commerce Casino,90040,NLH,360,300,60,0.8333333333333334,LA Poker Classic 2023 - Event #30 - NLH 30th Anniversary
904,1/31/2023 6:00:00 pm,Hollywood Park Casino,90303,NLH,100,67,33,0.67,"No-Limit Hold'em ($10,000 Guaranteed)"
905,2/01/2023 11:00:00 am,Commerce Casino,90040,Stud,600,510,90,0.85,LA Poker Classic 2023 - Event #33 - 7 Card Stud Mixed Game Championship
906,2/01/2023 11:30:00 am,The Gardens Casino,90716,NLH,130,100,30,0.7692307692307693,$10K NLH Bounty
907,2/01/2023 12:00:00 pm,Commerce Casino,90040,NLH,250,200,50,0.8,LA Poker Classic 2023 - Event #34 - NLH
908,2/01/2023 2:15:00 pm,The Gardens Casino,90716,NLH,125,100,25,0.8,Sit-N-Go
909,2/01/2023 4:00:00 pm,The Gardens Casino,90716,NLH,125,100,25,0.8,Sit-N-Go
910,2/01/2023 5:00:00 pm,Commerce Casino,90040,NLH,360,300,60,0.8333333333333334,LA Poker Classic 2023 - Event #30 - NLH 30th Anniversary
911,2/01/2023 6:00:00 pm,Hollywood Park Casino,90303,NLH,100,67,33,0.67,"No-Limit Hold'em Bounty ($10,000 Guaranteed)"
912,2/01/2023 6:00:00 pm,The Gardens Casino,90716,NLH,125,100,25,0.8,Sit-N-Go
913,2/02/2023 11:00:00 am,Commerce Casino,90040,Stud8,600,510,90,0.85,LA Poker Classic 2023 - Event #35 - 7 Card Stud 8 Mixed Game Championship
914,2/02/2023 11:30:00 am,The Gardens Casino,90716,NLH,130,100,30,0.7692307692307693,$10K NLH
915,2/02/2023 12:00:00 pm,Commerce Casino,90040,NLH,250,200,50,0.8,LA Poker Classic 2023 - Event #36 - NLH
916,2/02/2023 2:15:00 pm,The Gardens Casino,90716,NLH,125,100,25,0.8,Sit-N-Go
917,2/02/2023 4:00:00 pm,The Gardens Casino,90716,NLH,125,100,25,0.8,Sit-N-Go
918,2/02/2023 5:00:00 pm,Commerce Casino,90040,NLH,360,300,60,0.8333333333333334,LA Poker Classic 2023 - Event #30 - NLH 30th Anniversary
919,2/02/2023 6:00:00 pm,Hollywood Park Casino,90303,NLH,100,67,33,0.67,"No-Limit Hold'em Bounty ($10,000 Guaranteed)"
920,2/02/2023 6:00:00 pm,The Gardens Casino,90716,NLH,125,100,25,0.8,Sit-N-Go
921,2/03/2023 10:00:00 am,Hollywood Park Casino,90303,NLH,200,154,46,0.77,"No-Limit Hold'em Bounty ($10,000 Guaranteed)"
922,2/03/2023 11:00:00 am,Commerce Casino,90040,M,600,510,90,0.85,LA Poker Classic 2023 - Event #37 - H.E.R.O.S. Mixed Game Championship
923,2/03/2023 11:30:00 am,The Gardens Casino,90716,NLH,240,200,40,0.8333333333333334,$20K NLH
924,2/03/2023 12:00:00 pm,Commerce Casino,90040,NLH,250,200,50,0.8,LA Poker Classic 2023 - Event #38 - NLH
925,2/03/2023 2:15:00 pm,The Gardens Casino,90716,NLH,125,100,25,0.8,Sit-N-Go
926,2/03/2023 4:00:00 pm,The Gardens Casino,90716,NLH,125,100,25,0.8,Sit-N-Go
927,2/03/2023 5:00:00 pm,Commerce Casino,90040,NLH,360,300,60,0.8333333333333334,LA Poker Classic 2023 - Event #30 - NLH 30th Anniversary
928,2/03/2023 6:00:00 pm,The Gardens Casino,90716,NLH,125,100,25,0.8,Sit-N-Go
929,2/04/2023 10:00:00 am,Hollywood Park Casino,90303,NLH,100,67,33,0.67,"No-Limit Hold'em ($10,000 Guaranteed)"
930,2/04/2023 11:00:00 am,Commerce Casino,90040,NLH,360,300,60,0.8333333333333334,LA Poker Classic 2023 - Event #30 - NLH 30th Anniversary
931,2/04/2023 11:30:00 am,The Gardens Casino,90716,NLH,250,210,40,0.84,$25K NLH
932,2/04/2023 2:15:00 pm,The Gardens Casino,90716,NLH,125,100,25,0.8,Sit-N-Go
933,2/04/2023 4:00:00 pm,Commerce Casino,90040,NLH,360,300,60,0.8333333333333334,LA Poker Classic 2023 - Event #30 - NLH 30th Anniversary
934,2/04/2023 4:00:00 pm,The Gardens Casino,90716,NLH,125,100,25,0.8,Sit-N-Go
935,2/04/2023 6:00:00 pm,The Gardens Casino,90716,NLH,125,100,25,0.8,Sit-N-Go
936,2/05/2023 12:00:00 pm,Commerce Casino,90040,NLH,360,300,60,0.8333333333333334,LA Poker Classic 2023 - Event #39 - NLH
937,2/05/2023 2:00:00 pm,Commerce Casino,90040,FLTOE,1200,1070,130,0.8916666666666667,LA Poker Classic 2023 - Event #40 - T.O.E.
938,2/05/2023 6:00:00 pm,Commerce Casino,90040,NLH,200,170,30,0.85,LA Poker Classic 2023 - Event #41 - NLH Turbo
939,2/06/2023 10:00:00 am,Hollywood Park Casino,90303,NLH,120,95,25,0.7916666666666666,"No-Limit Hold'em ($4,000 Guaranteed)"
940,2/06/2023 11:00:00 am,Commerce Casino,90040,MLO,400,330,70,0.825,LA Poker Classic 2023 - Event #42 - NL/PLO Partners Event
941,2/06/2023 12:00:00 pm,Commerce Casino,90040,NLH,600,510,90,0.85,LA Poker Classic 2023 - Event #43 - NLH 40/40
942,2/06/2023 6:00:00 pm,Hollywood Park Casino,90303,NLH,100,67,33,0.67,"No-Limit Hold'em ($10,000 Guaranteed)"
943,2/06/2023 6:00:00 pm,Commerce Casino,90040,NLH,200,170,30,0.85,LA Poker Classic 2023 - Event #44 - NLH Turbo
944,2/07/2023 10:00:00 am,Hollywood Park Casino,90303,NLH,120,95,25,0.7916666666666666,"No-Limit Hold'em ($4,000 Guaranteed)"
945,2/07/2023 11:00:00 am,Commerce Casino,90040,M,600,510,90,0.85,LA Poker Classic 2023 - Event #45 - H.E.R.O.S. Partners Event
946,2/07/2023 12:00:00 pm,Commerce Casino,90040,NLH,600,510,90,0.85,LA Poker Classic 2023 - Event #43 - NLH 40/40
947,2/07/2023 6:00:00 pm,Hollywood Park Casino,90303,NLH,100,67,33,0.67,"No-Limit Hold'em ($10,000 Guaranteed)"
948,2/07/2023 6:00:00 pm,Commerce Casino,90040,NLH,200,170,30,0.85,LA Poker Classic 2023 - Event #46 - NLH Turbo
949,2/08/2023 11:00:00 am,Commerce Casino,90040,FLTOE,600,510,90,0.85,LA Poker Classic 2023 - Event #47 - T.O.E.
950,2/08/2023 11:30:00 am,The Gardens Casino,90716,NLH,130,100,30,0.7692307692307693,$10K NLH Bounty
951,2/08/2023 12:00:00 pm,Commerce Casino,90040,NLH,600,510,90,0.85,LA Poker Classic 2023 - Event #43 - NLH 40/40
952,2/08/2023 2:15:00 pm,The Gardens Casino,90716,NLH,125,100,25,0.8,Sit-N-Go
953,2/08/2023 4:00:00 pm,The Gardens Casino,90716,NLH,125,100,25,0.8,Sit-N-Go
954,2/08/2023 6:00:00 pm,Hollywood Park Casino,90303,NLH,100,67,33,0.67,"No-Limit Hold'em Bounty ($10,000 Guaranteed)"
955,2/08/2023 6:00:00 pm,Commerce Casino,90040,NLH,200,170,30,0.85,LA Poker Classic 2023 - Event #48 - NLH Turbo
956,2/08/2023 6:00:00 pm,The Gardens Casino,90716,NLH,125,100,25,0.8,Sit-N-Go
957,2/09/2023 11:00:00 am,Commerce Casino,90040,M,600,510,90,0.85,LA Poker Classic 2023 - Event #49 - 9 Game Mix
958,2/09/2023 11:30:00 am,The Gardens Casino,90716,NLH,130,100,30,0.7692307692307693,$10K NLH
959,2/09/2023 12:00:00 pm,Commerce Casino,90040,NLH,600,510,90,0.85,LA Poker Classic 2023 - Event #43 - NLH 40/40
960,2/09/2023 2:15:00 pm,The Gardens Casino,90716,NLH,125,100,25,0.8,Sit-N-Go
961,2/09/2023 4:00:00 pm,The Gardens Casino,90716,NLH,125,100,25,0.8,Sit-N-Go
962,2/09/2023 6:00:00 pm,Hollywood Park Casino,90303,NLH,100,67,33,0.67,"No-Limit Hold'em Bounty ($10,000 Guaranteed)"
963,2/09/2023 6:00:00 pm,Commerce Casino,90040,NLH,200,170,30,0.85,LA Poker Classic 2023 - Event #50 - NLH Turbo
964,2/09/2023 6:00:00 pm,The Gardens Casino,90716,NLH,125,100,25,0.8,Sit-N-Go
965,2/10/2023 10:00:00 am,Hollywood Park Casino,90303,NLH,200,154,46,0.77,"No-Limit Hold'em Bounty ($10,000 Guaranteed)"
966,2/10/2023 11:00:00 am,Commerce Casino,90040,NLH,600,510,90,0.85,LA Poker Classic 2023 - Event #43 - NLH 40/40
967,2/10/2023 11:30:00 am,The Gardens Casino,90716,NLH,240,200,40,0.8333333333333334,$20K NLH
968,2/10/2023 2:15:00 pm,The Gardens Casino,90716,NLH,125,100,25,0.8,Sit-N-Go
969,2/10/2023 4:00:00 pm,The Gardens Casino,90716,NLH,125,100,25,0.8,Sit-N-Go
970,2/10/2023 5:00:00 pm,Commerce Casino,90040,NLH,600,510,90,0.85,LA Poker Classic 2023 - Event #43 - NLH 40/40
971,2/10/2023 6:00:00 pm,The Gardens Casino,90716,NLH,125,100,25,0.8,Sit-N-Go
972,2/11/2023 10:00:00 am,Hollywood Park Casino,90303,NLH,100,67,33,0.67,"No-Limit Hold'em ($10,000 Guaranteed)"
973,2/11/2023 11:30:00 am,The Gardens Casino,90716,NLH,250,210,40,0.84,$25K NLH
974,2/11/2023 12:00:00 pm,Commerce Casino,90040,NLH,360,300,60,0.8333333333333334,LA Poker Classic 2023 - Event #51 - NLH
975,2/11/2023 2:15:00 pm,The Gardens Casino,90716,NLH,125,100,25,0.8,Sit-N-Go
976,2/11/2023 4:00:00 pm,The Gardens Casino,90716,NLH,125,100,25,0.8,Sit-N-Go
977,2/11/2023 6:00:00 pm,Commerce Casino,90040,NLH,200,170,30,0.85,LA Poker Classic 2023 - Event #52 - NLH Turbo
978,2/11/2023 6:00:00 pm,The Gardens Casino,90716,NLH,125,100,25,0.8,Sit-N-Go
979,2/13/2023 10:00:00 am,Hollywood Park Casino,90303,NLH,120,95,25,0.7916666666666666,"No-Limit Hold'em ($4,000 Guaranteed)"
980,2/13/2023 11:00:00 am,Commerce Casino,90040,FLMTD,600,510,90,0.85,LA Poker Classic 2023 - Event #53 - Triple Triple Draw
981,2/13/2023 12:00:00 pm,Commerce Casino,90040,NLH,360,300,60,0.8333333333333334,LA Poker Classic 2023 - Event #54 - NLH
982,2/13/2023 6:00:00 pm,Hollywood Park Casino,90303,NLH,100,67,33,0.67,"No-Limit Hold'em ($10,000 Guaranteed)"
983,2/13/2023 6:00:00 pm,Commerce Casino,90040,NLH,200,170,30,0.85,LA Poker Classic 2023 - Satellite - Mega Satellite for LAPC Classic
984,2/14/2023 10:00:00 am,Hollywood Park Casino,90303,NLH,120,95,25,0.7916666666666666,"No-Limit Hold'em ($4,000 Guaranteed)"
985,2/14/2023 11:00:00 am,Commerce Casino,90040,NLH,200,170,30,0.85,LA Poker Classic 2023 - Satellite - Mega Satellite for LAPC Classic
986,2/14/2023 12:00:00 pm,Commerce Casino,90040,FLO8,1200,1070,130,0.8916666666666667,LA Poker Classic 2023 - Event #55 - Omaha 8
987,2/14/2023 2:00:00 pm,Commerce Casino,90040,NLH,200,170,30,0.85,LA Poker Classic 2023 - Satellite - Mega Satellite for LAPC Classic
988,2/14/2023 6:00:00 pm,Hollywood Park Casino,90303,NLH,100,67,33,0.67,"No-Limit Hold'em ($10,000 Guaranteed)"
989,2/14/2023 6:00:00 pm,Commerce Casino,90040,NLH,200,170,30,0.85,LA Poker Classic 2023 - Satellite - Mega Satellite for LAPC Classic
990,2/15/2023 12:00:00 pm,Commerce Casino,90040,NLH,1200,1070,130,0.8916666666666667,LA Poker Classic 2023 - Event #56 - LAPC Classic
991,2/15/2023 2:15:00 pm,The Gardens Casino,90716,NLH,125,100,25,0.8,Sit-N-Go
992,2/15/2023 4:00:00 pm,The Gardens Casino,90716,NLH,125,100,25,0.8,Sit-N-Go
993,2/15/2023 6:00:00 pm,Hollywood Park Casino,90303,NLH,100,67,33,0.67,"No-Limit Hold'em Bounty ($10,000 Guaranteed)"
994,2/15/2023 6:00:00 pm,Commerce Casino,90040,NLH,200,170,30,0.85,LA Poker Classic 2023 - Satellite - Mega Satellite for LAPC Classic
995,2/15/2023 6:00:00 pm,The Gardens Casino,90716,NLH,125,100,25,0.8,Sit-N-Go
996,2/16/2023 11:30:00 am,The Gardens Casino,90716,NLH,130,100,30,0.7692307692307693,$10K NLH
997,2/16/2023 12:00:00 pm,Commerce Casino,90040,NLH,1200,1070,130,0.8916666666666667,LA Poker Classic 2023 - Event #56 - LAPC Classic
998,2/16/2023 2:15:00 pm,The Gardens Casino,90716,NLH,125,100,25,0.8,Sit-N-Go
999,2/16/2023 4:00:00 pm,The Gardens Casino,90716,NLH,125,100,25,0.8,Sit-N-Go
1000,2/16/2023 6:00:00 pm,Hollywood Park Casino,90303,NLH,100,67,33,0.67,"No-Limit Hold'em Bounty ($10,000 Guaranteed)"
1001,2/16/2023 6:00:00 pm,Commerce Casino,90040,NLH,200,170,30,0.85,LA Poker Classic 2023 - Satellite - Mega Satellite for LAPC Classic
1002,2/16/2023 6:00:00 pm,The Gardens Casino,90716,NLH,125,100,25,0.8,Sit-N-Go
1003,2/17/2023 10:00:00 am,Hollywood Park Casino,90303,NLH,200,154,46,0.77,"No-Limit Hold'em Bounty ($10,000 Guaranteed)"
1004,2/17/2023 11:30:00 am,The Gardens Casino,90716,NLH,240,200,40,0.8333333333333334,$20K NLH
1005,2/17/2023 12:00:00 pm,Commerce Casino,90040,NLH,1200,1070,130,0.8916666666666667,LA Poker Classic 2023 - Event #56 - LAPC Classic
1006,2/17/2023 2:15:00 pm,The Gardens Casino,90716,NLH,125,100,25,0.8,Sit-N-Go
1007,2/17/2023 4:00:00 pm,The Gardens Casino,90716,NLH,125,100,25,0.8,Sit-N-Go
1008,2/17/2023 6:00:00 pm,Commerce Casino,90040,NLH,200,170,30,0.85,LA Poker Classic 2023 - Satellite - Mega Satellite for LAPC Classic
1009,2/17/2023 6:00:00 pm,The Gardens Casino,90716,NLH,125,100,25,0.8,Sit-N-Go
1010,2/18/2023 10:00:00 am,Hollywood Park Casino,90303,NLH,100,67,33,0.67,"No-Limit Hold'em ($10,000 Guaranteed)"
1011,2/18/2023 11:00:00 am,Commerce Casino,90040,NLH,1200,1070,130,0.8916666666666667,LA Poker Classic 2023 - Event #56 - LAPC Classic
1012,2/18/2023 11:30:00 am,The Gardens Casino,90716,NLH,250,210,40,0.84,$25K NLH
1013,2/18/2023 2:15:00 pm,The Gardens Casino,90716,NLH,125,100,25,0.8,Sit-N-Go
1014,2/18/2023 4:00:00 pm,The Gardens Casino,90716,NLH,125,100,25,0.8,Sit-N-Go
1015,2/18/2023 6:00:00 pm,Commerce Casino,90040,NLH,200,170,30,0.85,LA Poker Classic 2023 - Satellite - Mega Satellite for LAPC Classic
1016,2/18/2023 6:00:00 pm,The Gardens Casino,90716,NLH,125,100,25,0.8,Sit-N-Go
1017,2/19/2023 11:00:00 am,Commerce Casino,90040,NLH,1200,1070,130,0.8916666666666667,LA Poker Classic 2023 - Event #56 - LAPC Classic
1018,2/19/2023 5:00:00 pm,Commerce Casino,90040,NLH,450,400,50,0.8888888888888888,LA Poker Classic 2023 - Event #57 - NLH Survivor
1019,2/20/2023 10:00:00 am,Hollywood Park Casino,90303,NLH,120,95,25,0.7916666666666666,"No-Limit Hold'em ($4,000 Guaranteed)"
1020,2/20/2023 12:00:00 pm,Commerce Casino,90040,NLH,1200,1070,130,0.8916666666666667,LA Poker Classic 2023 - Event #58 - NLH
1021,2/20/2023 5:00:00 pm,Commerce Casino,90040,NL27S,600,510,90,0.85,LA Poker Classic 2023 - Event #59 - NL 2-7 Single Draw
1022,2/20/2023 6:00:00 pm,Hollywood Park Casino,90303,NLH,100,67,33,0.67,"No-Limit Hold'em ($10,000 Guaranteed)"
1023,2/21/2023 10:00:00 am,Hollywood Park Casino,90303,NLH,120,95,25,0.7916666666666666,"No-Limit Hold'em ($4,000 Guaranteed)"
1024,2/21/2023 11:00:00 am,Commerce Casino,90040,MLMO,1200,1070,130,0.8916666666666667,LA Poker Classic 2023 - Event #60 - Mixed Omaha
1025,2/21/2023 12:00:00 pm,Commerce Casino,90040,NLH,250,200,50,0.8,LA Poker Classic 2023 - Event #61 - NLH
1026,2/21/2023 6:00:00 pm,Hollywood Park Casino,90303,NLH,100,67,33,0.67,"No-Limit Hold'em ($10,000 Guaranteed)"
1027,2/21/2023 6:00:00 pm,Commerce Casino,90040,NLH,200,170,30,0.85,"LA Poker Classic 2023 - Satellite - Step Satellite for $1,100 Mega Satellite"
1028,2/22/2023 11:00:00 am,Commerce Casino,90040,M,1200,1070,130,0.8916666666666667,LA Poker Classic 2023 - Event #62 - Game of T.H.R.O.E.S.
1029,2/22/2023 11:30:00 am,The Gardens Casino,90716,NLH,130,100,30,0.7692307692307693,$10K NLH Bounty
1030,2/22/2023 12:00:00 pm,Commerce Casino,90040,NLH,250,200,50,0.8,LA Poker Classic 2023 - Event #63 - NLH
1031,2/22/2023 2:15:00 pm,The Gardens Casino,90716,NLH,125,100,25,0.8,Sit-N-Go
1032,2/22/2023 4:00:00 pm,The Gardens Casino,90716,NLH,125,100,25,0.8,Sit-N-Go
1033,2/22/2023 6:00:00 pm,Hollywood Park Casino,90303,NLH,100,67,33,0.67,"No-Limit Hold'em Bounty ($10,000 Guaranteed)"
1034,2/22/2023 6:00:00 pm,Commerce Casino,90040,NLH,200,170,30,0.85,"LA Poker Classic 2023 - Satellite - Step Satellite for $1,100 Mega Satellite"
1035,2/22/2023 6:00:00 pm,The Gardens Casino,90716,NLH,125,100,25,0.8,Sit-N-Go
1036,2/23/2023 11:30:00 am,The Gardens Casino,90716,NLH,130,100,30,0.7692307692307693,$10K NLH
1037,2/23/2023 12:00:00 pm,Commerce Casino,90040,NLH,1200,1070,130,0.8916666666666667,LA Poker Classic 2023 - Event #64 - NLH Bomb Pot on the Dealer Push
1038,2/23/2023 12:00:00 pm,Commerce Casino,90040,NLH,250,200,50,0.8,LA Poker Classic 2023 - Event #65 - NLH
1039,2/23/2023 2:15:00 pm,The Gardens Casino,90716,NLH,125,100,25,0.8,Sit-N-Go
1040,2/23/2023 4:00:00 pm,The Gardens Casino,90716,NLH,125,100,25,0.8,Sit-N-Go
1041,2/23/2023 6:00:00 pm,Hollywood Park Casino,90303,NLH,100,67,33,0.67,"No-Limit Hold'em Bounty ($10,000 Guaranteed)"
1042,2/23/2023 6:00:00 pm,Commerce Casino,90040,NLH,200,170,30,0.85,"LA Poker Classic 2023 - Satellite - Step Satellite for $1,100 Mega Satellite"
1043,2/23/2023 6:00:00 pm,The Gardens Casino,90716,NLH,125,100,25,0.8,Sit-N-Go
1044,2/24/2023 10:00:00 am,Hollywood Park Casino,90303,NLH,200,154,46,0.77,"No-Limit Hold'em Bounty ($10,000 Guaranteed)"
1045,2/24/2023 11:30:00 am,The Gardens Casino,90716,NLH,240,200,40,0.8333333333333334,$20K NLH
1046,2/24/2023 12:00:00 pm,Commerce Casino,90040,NLH,1100,1025,75,0.9318181818181818,LA Poker Classic 2023 - Satellite - Mega Satellite for Main Event
1047,2/24/2023 2:15:00 pm,The Gardens Casino,90716,NLH,125,100,25,0.8,Sit-N-Go
1048,2/24/2023 4:00:00 pm,The Gardens Casino,90716,NLH,125,100,25,0.8,Sit-N-Go
1049,2/24/2023 5:00:00 pm,Commerce Casino,90040,NLH,1100,1025,75,0.9318181818181818,LA Poker Classic 2023 - Satellite - Mega Satellite for Main Event
1050,2/24/2023 6:00:00 pm,The Gardens Casino,90716,NLH,125,100,25,0.8,Sit-N-Go
1051,2/25/2023 10:00:00 am,Hollywood Park Casino,90303,NLH,100,67,33,0.67,"No-Limit Hold'em ($10,000 Guaranteed)"
1052,2/25/2023 11:00:00 am,Commerce Casino,90040,NLH,10000,9300,700,0.93,LA Poker Classic 2023 - Event #66 - LAPC Main Event
1053,2/25/2023 11:30:00 am,The Gardens Casino,90716,NLH,250,210,40,0.84,$25K NLH
1054,2/25/2023 2:15:00 pm,The Gardens Casino,90716,NLH,125,100,25,0.8,Sit-N-Go
1055,2/25/2023 4:00:00 pm,Commerce Casino,90040,NLH,1100,1025,75,0.9318181818181818,LA Poker Classic 2023 - Satellite - Mega Satellite for Main Event
1056,2/25/2023 4:00:00 pm,The Gardens Casino,90716,NLH,125,100,25,0.8,Sit-N-Go
1057,2/25/2023 6:00:00 pm,The Gardens Casino,90716,NLH,125,100,25,0.8,Sit-N-Go
1058,2/26/2023 11:00:00 am,Commerce Casino,90040,NLH,10000,9300,700,0.93,LA Poker Classic 2023 - Event #66 - LAPC Main Event
1059,2/26/2023 1:00:00 pm,Commerce Casino,90040,NLH,1100,1025,75,0.9318181818181818,LA Poker Classic 2023 - Satellite - Mega Satellite for Main Event
1060,2/27/2023 10:00:00 am,Hollywood Park Casino,90303,NLH,120,95,25,0.7916666666666666,"No-Limit Hold'em ($4,000 Guaranteed)"
1061,2/27/2023 12:00:00 pm,Commerce Casino,90040,NLH,1200,1070,130,0.8916666666666667,LA Poker Classic 2023 - Event #67 - NLH 6 Max
1062,2/27/2023 6:00:00 pm,Hollywood Park Casino,90303,NLH,100,67,33,0.67,"No-Limit Hold'em ($10,000 Guaranteed)"
1063,2/27/2023 6:00:00 pm,Commerce Casino,90040,NLH,200,170,30,0.85,LA Poker Classic 2023 - Event #68 - NLH Turbo
1064,2/28/2023 10:00:00 am,Hollywood Park Casino,90303,NLH,120,95,25,0.7916666666666666,"No-Limit Hold'em ($4,000 Guaranteed)"
1065,2/28/2023 12:00:00 pm,Commerce Casino,90040,NLH,360,300,60,0.8333333333333334,LA Poker Classic 2023 - Event #69 - NLH Bounty Multiplier
1066,2/28/2023 5:00:00 pm,Commerce Casino,90040,PLDB BP PLO,250,200,50,0.8,LA Poker Classic 2023 - Event #70 - Double Board Bomb Pot PLO
1067,2/28/2023 6:00:00 pm,Hollywood Park Casino,90303,NLH,100,67,33,0.67,"No-Limit Hold'em ($10,000 Guaranteed)"
1068,3/01/2023 11:00:00 am,Commerce Casino,90040,NLH,250,200,50,0.8,LA Poker Classic 2023 - Event #71 - NLH The Remington
1069,3/01/2023 11:30:00 am,The Gardens Casino,90716,NLH,130,100,30,0.7692307692307693,$10K NLH Bounty
1070,3/01/2023 2:15:00 pm,The Gardens Casino,90716,NLH,125,100,25,0.8,Sit-N-Go
1071,3/01/2023 4:00:00 pm,Commerce Casino,90040,NLH,250,200,50,0.8,LA Poker Classic 2023 - Event #71 - NLH The Remington
1072,3/01/2023 4:00:00 pm,The Gardens Casino,90716,NLH,125,100,25,0.8,Sit-N-Go
1073,3/01/2023 6:00:00 pm,Hollywood Park Casino,90303,NLH,100,67,33,0.67,"No-Limit Hold'em Bounty ($10,000 Guaranteed)"
1074,3/01/2023 6:00:00 pm,The Gardens Casino,90716,NLH,125,100,25,0.8,Sit-N-Go
1075,3/02/2023 11:00:00 am,Commerce Casino,90040,NLH,250,200,50,0.8,LA Poker Classic 2023 - Event #71 - NLH The Remington
1076,3/02/2023 11:30:00 am,The Gardens Casino,90716,NLH,130,100,30,0.7692307692307693,$10K NLH
1077,3/02/2023 2:15:00 pm,The Gardens Casino,90716,NLH,125,100,25,0.8,Sit-N-Go
1078,3/02/2023 4:00:00 pm,Commerce Casino,90040,NLH,250,200,50,0.8,LA Poker Classic 2023 - Event #71 - NLH The Remington
1079,3/02/2023 4:00:00 pm,The Gardens Casino,90716,NLH,125,100,25,0.8,Sit-N-Go
1080,3/02/2023 6:00:00 pm,Hollywood Park Casino,90303,NLH,100,67,33,0.67,"No-Limit Hold'em Bounty ($10,000 Guaranteed)"
1081,3/02/2023 6:00:00 pm,The Gardens Casino,90716,NLH,125,100,25,0.8,Sit-N-Go
1082,3/03/2023 10:00:00 am,Hollywood Park Casino,90303,NLH,200,154,46,0.77,"No-Limit Hold'em Bounty ($10,000 Guaranteed)"
1083,3/03/2023 11:00:00 am,Commerce Casino,90040,NLH,250,200,50,0.8,LA Poker Classic 2023 - Event #71 - NLH The Remington
1084,3/03/2023 11:30:00 am,The Gardens Casino,90716,NLH,240,200,40,0.8333333333333334,$20K NLH
1085,3/03/2023 2:15:00 pm,The Gardens Casino,90716,NLH,125,100,25,0.8,Sit-N-Go
1086,3/03/2023 4:00:00 pm,Commerce Casino,90040,NLH,250,200,50,0.8,LA Poker Classic 2023 - Event #71 - NLH The Remington
1087,3/03/2023 4:00:00 pm,The Gardens Casino,90716,NLH,125,100,25,0.8,Sit-N-Go
1088,3/03/2023 6:00:00 pm,The Gardens Casino,90716,NLH,125,100,25,0.8,Sit-N-Go
1089,3/04/2023 10:00:00 am,Hollywood Park Casino,90303,NLH,100,67,33,0.67,"No-Limit Hold'em ($10,000 Guaranteed)"
1090,3/04/2023 11:30:00 am,The Gardens Casino,90716,NLH,250,210,40,0.84,$25K NLH
1091,3/04/2023 12:00:00 pm,Commerce Casino,90040,NLH,360,300,60,0.8333333333333334,LA Poker Classic 2023 - Event #72 - NLH
1092,3/04/2023 2:15:00 pm,The Gardens Casino,90716,NLH,125,100,25,0.8,Sit-N-Go
1093,3/04/2023 4:00:00 pm,The Gardens Casino,90716,NLH,125,100,25,0.8,Sit-N-Go
1094,3/04/2023 5:00:00 pm,Commerce Casino,90040,NLH,360,300,60,0.8333333333333334,LA Poker Classic 2023 - Event #73 - NLH
1095,3/04/2023 6:00:00 pm,The Gardens Casino,90716,NLH,125,100,25,0.8,Sit-N-Go
1096,3/05/2023 12:00:00 pm,Commerce Casino,90040,NLH,360,300,60,0.8333333333333334,LA Poker Classic 2023 - Event #74 - NLH
1097,3/05/2023 5:00:00 pm,Commerce Casino,90040,NLH,250,200,50,0.8,LA Poker Classic 2023 - Event #75 - NLH Bounty
1098,3/06/2023 10:00:00 am,Hollywood Park Casino,90303,NLH,120,95,25,0.7916666666666666,"No-Limit Hold'em ($4,000 Guaranteed)"
1099,3/06/2023 4:00:00 pm,Commerce Casino,90040,NLH,125,95,30,0.76,No Limit Hold'em
1100,3/06/2023 6:00:00 pm,Hollywood Park Casino,90303,NLH,100,67,33,0.67,"No-Limit Hold'em ($10,000 Guaranteed)"
1101,3/07/2023 10:00:00 am,Hollywood Park Casino,90303,NLH,120,95,25,0.7916666666666666,"No-Limit Hold'em ($4,000 Guaranteed)"
1102,3/07/2023 4:00:00 pm,Commerce Casino,90040,NLH,125,95,30,0.76,No Limit Hold'em
1103,3/07/2023 6:00:00 pm,Hollywood Park Casino,90303,NLH,100,67,33,0.67,"No-Limit Hold'em ($10,000 Guaranteed)"
1104,3/08/2023 11:30:00 am,The Gardens Casino,90716,NLH,130,100,30,0.7692307692307693,$10K NLH Bounty
1105,3/08/2023 2:15:00 pm,The Gardens Casino,90716,NLH,125,100,25,0.8,Sit-N-Go
1106,3/08/2023 4:00:00 pm,Commerce Casino,90040,NLH,125,95,30,0.76,No Limit Hold'em
1107,3/08/2023 4:00:00 pm,The Gardens Casino,90716,NLH,125,100,25,0.8,Sit-N-Go
1108,3/08/2023 6:00:00 pm,Hollywood Park Casino,90303,NLH,100,67,33,0.67,"No-Limit Hold'em Bounty ($10,000 Guaranteed)"
1109,3/08/2023 6:00:00 pm,The Gardens Casino,90716,NLH,125,100,25,0.8,Sit-N-Go
1110,3/09/2023 11:30:00 am,The Gardens Casino,90716,NLH,130,100,30,0.7692307692307693,$10K NLH
1111,3/09/2023 2:15:00 pm,The Gardens Casino,90716,NLH,125,100,25,0.8,Sit-N-Go
1112,3/09/2023 4:00:00 pm,Commerce Casino,90040,NLH,125,95,30,0.76,No Limit Hold'em
1113,3/09/2023 4:00:00 pm,The Gardens Casino,90716,NLH,125,100,25,0.8,Sit-N-Go
1114,3/09/2023 6:00:00 pm,Hollywood Park Casino,90303,NLH,100,67,33,0.67,"No-Limit Hold'em Bounty ($10,000 Guaranteed)"
1115,3/09/2023 6:00:00 pm,The Gardens Casino,90716,NLH,125,100,25,0.8,Sit-N-Go
1116,3/10/2023 10:00:00 am,Hollywood Park Casino,90303,NLH,200,154,46,0.77,"No-Limit Hold'em Bounty ($10,000 Guaranteed)"
1117,3/10/2023 11:30:00 am,The Gardens Casino,90716,NLH,240,200,40,0.8333333333333334,$20K NLH
1118,3/10/2023 2:15:00 pm,The Gardens Casino,90716,NLH,125,100,25,0.8,Sit-N-Go
1119,3/10/2023 4:00:00 pm,Commerce Casino,90040,NLH,125,95,30,0.76,No Limit Hold'em
1120,3/10/2023 4:00:00 pm,The Gardens Casino,90716,NLH,125,100,25,0.8,Sit-N-Go
1121,3/10/2023 6:00:00 pm,The Gardens Casino,90716,NLH,125,100,25,0.8,Sit-N-Go
1122,3/11/2023 10:00:00 am,Hollywood Park Casino,90303,NLH,100,67,33,0.67,"No-Limit Hold'em ($10,000 Guaranteed)"
1123,3/11/2023 11:30:00 am,The Gardens Casino,90716,NLH,250,210,40,0.84,$25K NLH
1124,3/11/2023 1:00:00 pm,Commerce Casino,90040,NLH,250,195,55,0.78,"No-Limit Hold'em ($20,000 Guaranteed)"
1125,3/11/2023 2:15:00 pm,The Gardens Casino,90716,NLH,125,100,25,0.8,Sit-N-Go
1126,3/11/2023 4:00:00 pm,The Gardens Casino,90716,NLH,125,100,25,0.8,Sit-N-Go
1127,3/11/2023 6:00:00 pm,The Gardens Casino,90716,NLH,125,100,25,0.8,Sit-N-Go
1128,3/12/2023 1:00:00 pm,Commerce Casino,90040,NLH,250,195,55,0.78,"No-Limit Hold'em ($20,000 Guaranteed)"
1129,3/13/2023 10:00:00 am,Hollywood Park Casino,90303,NLH,120,95,25,0.7916666666666666,"No-Limit Hold'em ($4,000 Guaranteed)"
1130,3/13/2023 4:00:00 pm,Commerce Casino,90040,NLH,125,95,30,0.76,No Limit Hold'em
1131,3/13/2023 6:00:00 pm,Hollywood Park Casino,90303,NLH,100,67,33,0.67,"No-Limit Hold'em ($10,000 Guaranteed)"
1132,3/14/2023 10:00:00 am,Hollywood Park Casino,90303,NLH,120,95,25,0.7916666666666666,"No-Limit Hold'em ($4,000 Guaranteed)"
1133,3/14/2023 4:00:00 pm,Commerce Casino,90040,NLH,125,95,30,0.76,No Limit Hold'em
1134,3/14/2023 6:00:00 pm,Hollywood Park Casino,90303,NLH,100,67,33,0.67,"No-Limit Hold'em ($10,000 Guaranteed)"
1135,3/15/2023 11:30:00 am,The Gardens Casino,90716,NLH,130,100,30,0.7692307692307693,$10K NLH Bounty
1136,1/14/2023 6:00:00 pm,Casino Club,96002,NLH,80,70,10,0.875,No-Limit Hold'em Bounty
1137,1/15/2023 3:00:00 pm,Towers Casino,95945,NLH,50,38,12,0.76,Lucky Rebuy NLH
1138,1/15/2023 4:00:00 pm,Casino Club,96002,NLH,55,45,10,0.8181818181818182,NLH
1139,1/17/2023 6:00:00 pm,Casino Club,96002,NLH,55,45,10,0.8181818181818182,NLH
1140,1/17/2023 6:00:00 pm,Elk Valley Casino,95531,NLH,40,35,5,0.875,NLH
1141,1/18/2023 6:00:00 pm,Elk Valley Casino,95531,NLH,0,0,"rrive after 6PM, buy-in is $10.",1.1,NLH Free Roll
1142,1/18/2023 6:00:00 pm,Bear River Casino,95551,NLH,200,170,30,0.85,No-Limit Hold'em Deep Stack
1143,1/19/2023 6:00:00 pm,Casino Club,96002,NLH,55,45,10,0.8181818181818182,NLH
1144,1/21/2023 6:00:00 pm,Casino Club,96002,NLH,80,70,10,0.875,No-Limit Hold'em Bounty
1145,1/22/2023 3:00:00 pm,Towers Casino,95945,NLH,50,38,12,0.76,Lucky Rebuy NLH
1146,1/22/2023 4:00:00 pm,Casino Club,96002,NLH,55,45,10,0.8181818181818182,NLH
1147,1/24/2023 6:00:00 pm,Casino Club,96002,NLH,55,45,10,0.8181818181818182,NLH
1148,1/24/2023 6:00:00 pm,Elk Valley Casino,95531,NLH,40,35,5,0.875,NLH
1149,1/25/2023 6:00:00 pm,Elk Valley Casino,95531,NLH,0,0,"rrive after 6PM, buy-in is $10.",1.1,NLH Free Roll
1150,1/25/2023 6:00:00 pm,Bear River Casino,95551,NLH,80,68,12,0.85,No-Limit Hold'em Green Chip Bounty
1151,1/26/2023 6:00:00 pm,Casino Club,96002,NLH,55,45,10,0.8181818181818182,NLH
1152,1/28/2023 6:00:00 pm,Casino Club,96002,NLH,80,70,10,0.875,No-Limit Hold'em Bounty
1153,1/29/2023 3:00:00 pm,Towers Casino,95945,NLH,50,38,12,0.76,Lucky Rebuy NLH
1154,1/29/2023 4:00:00 pm,Casino Club,96002,NLH,55,45,10,0.8181818181818182,NLH
1155,1/29/2023 6:00:00 pm,Bear River Casino,95551,NLH,200,170,30,0.85,No-Limit Hold'em Black Chip Bounty
1156,1/31/2023 6:00:00 pm,Casino Club,96002,NLH,55,45,10,0.8181818181818182,NLH
1157,1/31/2023 6:00:00 pm,Elk Valley Casino,95531,NLH,40,35,5,0.875,NLH
1158,2/01/2023 6:00:00 pm,Elk Valley Casino,95531,NLH,0,0,"rrive after 6PM, buy-in is $10.",1.1,NLH Free Roll
1159,2/02/2023 6:00:00 pm,Casino Club,96002,NLH,55,45,10,0.8181818181818182,NLH
1160,2/04/2023 6:00:00 pm,Casino Club,96002,NLH,80,70,10,0.875,No-Limit Hold'em Bounty
1161,2/05/2023 3:00:00 pm,Towers Casino,95945,NLH,150,123,27,0.82,Super Sunday NLH
1162,2/05/2023 4:00:00 pm,Casino Club,96002,NLH,55,45,10,0.8181818181818182,NLH
1163,2/07/2023 6:00:00 pm,Casino Club,96002,NLH,55,45,10,0.8181818181818182,NLH
1164,2/07/2023 6:00:00 pm,Elk Valley Casino,95531,NLH,40,35,5,0.875,NLH
1165,2/08/2023 6:00:00 pm,Elk Valley Casino,95531,NLH,0,0,"rrive after 6PM, buy-in is $10.",1.1,NLH Free Roll
1166,2/08/2023 6:00:00 pm,Bear River Casino,95551,NLH,80,68,12,0.85,No-Limit Hold'em Green Chip Bounty
1167,2/09/2023 6:00:00 pm,Casino Club,96002,NLH,55,45,10,0.8181818181818182,NLH
1168,2/11/2023 6:00:00 pm,Casino Club,96002,NLH,80,70,10,0.875,No-Limit Hold'em Bounty
1169,2/12/2023 3:00:00 pm,Towers Casino,95945,NLH,50,38,12,0.76,Lucky Rebuy NLH
1170,2/12/2023 4:00:00 pm,Casino Club,96002,NLH,55,45,10,0.8181818181818182,NLH
1171,2/14/2023 6:00:00 pm,Casino Club,96002,NLH,55,45,10,0.8181818181818182,NLH
1172,2/14/2023 6:00:00 pm,Elk Valley Casino,95531,NLH,40,35,5,0.875,NLH
1173,2/15/2023 6:00:00 pm,Elk Valley Casino,95531,NLH,0,0,"rrive after 6PM, buy-in is $10.",1.1,NLH Free Roll
1174,2/16/2023 6:00:00 pm,Casino Club,96002,NLH,55,45,10,0.8181818181818182,NLH
1175,2/18/2023 6:00:00 pm,Casino Club,96002,NLH,80,70,10,0.875,No-Limit Hold'em Bounty
1176,2/19/2023 3:00:00 pm,Towers Casino,95945,NLH,50,38,12,0.76,Lucky Rebuy NLH
1177,2/19/2023 4:00:00 pm,Casino Club,96002,NLH,55,45,10,0.8181818181818182,NLH
1178,2/21/2023 6:00:00 pm,Casino Club,96002,NLH,55,45,10,0.8181818181818182,NLH
1179,2/21/2023 6:00:00 pm,Elk Valley Casino,95531,NLH,40,35,5,0.875,NLH
1180,2/22/2023 6:00:00 pm,Elk Valley Casino,95531,NLH,0,0,"rrive after 6PM, buy-in is $10.",1.1,NLH Free Roll
1181,2/22/2023 6:00:00 pm,Bear River Casino,95551,NLH,80,68,12,0.85,No-Limit Hold'em Green Chip Bounty
1182,2/23/2023 6:00:00 pm,Casino Club,96002,NLH,55,45,10,0.8181818181818182,NLH
1183,2/25/2023 6:00:00 pm,Casino Club,96002,NLH,80,70,10,0.875,No-Limit Hold'em Bounty
1184,2/26/2023 3:00:00 pm,Towers Casino,95945,NLH,50,38,12,0.76,Lucky Rebuy NLH
1185,2/26/2023 4:00:00 pm,Casino Club,96002,NLH,55,45,10,0.8181818181818182,NLH
1186,2/28/2023 6:00:00 pm,Casino Club,96002,NLH,55,45,10,0.8181818181818182,NLH
1187,2/28/2023 6:00:00 pm,Elk Valley Casino,95531,NLH,40,35,5,0.875,NLH
1188,3/01/2023 6:00:00 pm,Elk Valley Casino,95531,NLH,0,0,"rrive after 6PM, buy-in is $10.",1.1,NLH Free Roll
1189,3/02/2023 6:00:00 pm,Casino Club,96002,NLH,55,45,10,0.8181818181818182,NLH
1190,3/04/2023 6:00:00 pm,Casino Club,96002,NLH,80,70,10,0.875,No-Limit Hold'em Bounty
1191,3/05/2023 3:00:00 pm,Towers Casino,95945,NLH,150,123,27,0.82,Super Sunday NLH
1192,3/05/2023 4:00:00 pm,Casino Club,96002,NLH,55,45,10,0.8181818181818182,NLH
1193,3/07/2023 6:00:00 pm,Casino Club,96002,NLH,55,45,10,0.8181818181818182,NLH
1194,3/07/2023 6:00:00 pm,Elk Valley Casino,95531,NLH,40,35,5,0.875,NLH
1195,3/08/2023 6:00:00 pm,Elk Valley Casino,95531,NLH,0,0,"rrive after 6PM, buy-in is $10.",1.1,NLH Free Roll
1196,3/09/2023 6:00:00 pm,Casino Club,96002,NLH,55,45,10,0.8181818181818182,NLH
1197,3/11/2023 6:00:00 pm,Casino Club,96002,NLH,80,70,10,0.875,No-Limit Hold'em Bounty
1198,3/12/2023 3:00:00 pm,Towers Casino,95945,NLH,50,38,12,0.76,Lucky Rebuy NLH
1199,3/12/2023 4:00:00 pm,Casino Club,96002,NLH,55,45,10,0.8181818181818182,NLH
1200,3/14/2023 6:00:00 pm,Casino Club,96002,NLH,55,45,10,0.8181818181818182,NLH
1201,3/14/2023 6:00:00 pm,Elk Valley Casino,95531,NLH,40,35,5,0.875,NLH
1202,1/14/2023 10:00:00 am,Thunder Valley Casino,95648,NLH,400,330,70,0.825,2022-23 WSOP Circuit Event (Northern California-Winter) - Event #2 - The Opener NLH
1203,1/14/2023 10:00:00 am,Capitol Casino,95811,NLH,100,85,15,0.85,$100 BUY-IN 1K ADDED
1204,1/15/2023 9:00:00 am,Thunder Valley Casino,95648,NLH,120,100,20,0.8333333333333334,2022-23 WSOP Circuit Event (Northern California-Winter) - Satellite - Mega Satellite into $600 & $400 Ring Events
1205,1/15/2023 10:00:00 am,Capitol Casino,95811,NLH,60,50,10,0.8333333333333334,$60 DOUBLE STACK
1206,1/15/2023 12:00:00 pm,Thunder Valley Casino,95648,NLH,600,515,85,0.8583333333333333,2022-23 WSOP Circuit Event (Northern California-Winter) - Event #3 - NLH
1207,1/15/2023 6:00:00 pm,Thunder Valley Casino,95648,NLH,120,100,20,0.8333333333333334,2022-23 WSOP Circuit Event (Northern California-Winter) - Satellite - Mega Satellite into $600 & $400 Ring Events
1208,1/16/2023 9:00:00 am,Thunder Valley Casino,95648,NLH,120,100,20,0.8333333333333334,2022-23 WSOP Circuit Event (Northern California-Winter) - Satellite - Mega Satellite into $600 & $400 Ring Events
1209,1/16/2023 10:00:00 am,Thunder Valley Casino,95648,NLH,400,330,70,0.825,2022-23 WSOP Circuit Event (Northern California-Winter) - Event #4 - NLH
1210,1/16/2023 10:00:00 am,Capitol Casino,95811,NLH,30,25,5,0.8333333333333334,$30 MONDAY NLH
1211,1/16/2023 3:00:00 pm,Thunder Valley Casino,95648,FLO8,600,515,85,0.8583333333333333,2022-23 WSOP Circuit Event (Northern California-Winter) - Event #5 - Omaha 8+
1212,1/16/2023 6:00:00 pm,Thunder Valley Casino,95648,NLH,120,100,20,0.8333333333333334,2022-23 WSOP Circuit Event (Northern California-Winter) - Satellite - Mega Satellite into $600 & $400 Ring Events
1213,1/17/2023 9:00:00 am,Thunder Valley Casino,95648,NLH,120,100,20,0.8333333333333334,2022-23 WSOP Circuit Event (Northern California-Winter) - Satellite - Mega Satellite into $600 & $400 Ring Events
1214,1/17/2023 10:00:00 am,Thunder Valley Casino,95648,NLH,400,330,70,0.825,2022-23 WSOP Circuit Event (Northern California-Winter) - Event #6 - Eight Handed NLH
1215,1/17/2023 10:00:00 am,Capitol Casino,95811,NLH,30,25,5,0.8333333333333334,$30 TUESDAY DOUBLE RE-BUY
1216,1/17/2023 3:00:00 pm,Thunder Valley Casino,95648,HORSE,600,515,85,0.8583333333333333,2022-23 WSOP Circuit Event (Northern California-Winter) - Event #7 - H.O.R.S.E.
1217,1/17/2023 6:00:00 pm,Thunder Valley Casino,95648,NLH,120,100,20,0.8333333333333334,2022-23 WSOP Circuit Event (Northern California-Winter) - Satellite - Mega Satellite into $600 & $400 Ring Events
1218,1/18/2023 9:00:00 am,Thunder Valley Casino,95648,NLH,120,100,20,0.8333333333333334,2022-23 WSOP Circuit Event (Northern California-Winter) - Satellite - Mega Satellite into $600 & $400 Ring Events
1219,1/18/2023 10:00:00 am,Thunder Valley Casino,95648,NLH,400,330,70,0.825,2022-23 WSOP Circuit Event (Northern California-Winter) - Event #8 - Monster Stack NLH
1220,1/18/2023 10:00:00 am,Capitol Casino,95811,NLH,30,25,5,0.8333333333333334,$30 WEDNESDAY NLH
1221,1/18/2023 3:00:00 pm,Thunder Valley Casino,95648,NLH,400,330,70,0.825,2022-23 WSOP Circuit Event (Northern California-Winter) - Event #8 - Monster Stack NLH
1222,1/19/2023 9:00:00 am,Thunder Valley Casino,95648,NLH,120,100,20,0.8333333333333334,2022-23 WSOP Circuit Event (Northern California-Winter) - Satellite - Mega Satellite into $600 & $400 Ring Events
1223,1/19/2023 10:00:00 am,Capitol Casino,95811,NLH,30,25,5,0.8333333333333334,$30 THURSDAY NLH
1224,1/19/2023 11:00:00 am,Thunder Valley Casino,95648,NLH,600,515,85,0.8583333333333333,2022-23 WSOP Circuit Event (Northern California-Winter) - Event #9 - Six Handed NLH
1225,1/19/2023 2:00:00 pm,Thunder Valley Casino,95648,NLH,75,60,15,0.8,2022-23 WSOP Circuit Event (Northern California-Winter) - Satellite - Step Satellite into $300 Main Event Mega Satellite
1226,1/19/2023 3:00:00 pm,Thunder Valley Casino,95648,NLH,3250,3000,250,0.9230769230769232,2022-23 WSOP Circuit Event (Northern California-Winter) - Event #10 - High Roller NLH
1227,1/19/2023 6:00:00 pm,Thunder Valley Casino,95648,NLH,300,250,50,0.8333333333333334,2022-23 WSOP Circuit Event (Northern California-Winter) - Satellite - Mega Satellite into Main Event
1228,1/20/2023 9:00:00 am,Thunder Valley Casino,95648,NLH,300,250,50,0.8333333333333334,2022-23 WSOP Circuit Event (Northern California-Winter) - Satellite - Mega Satellite Turbo into Main Event
1229,1/20/2023 10:00:00 am,Capitol Casino,95811,NLH,30,25,5,0.8333333333333334,$30 FRIDAY NLH
1230,1/20/2023 11:00:00 am,Thunder Valley Casino,95648,NLH,1700,1515,185,0.8911764705882353,2022-23 WSOP Circuit Event (Northern California-Winter) - Event #11 - Main Event
1231,1/20/2023 2:00:00 pm,Thunder Valley Casino,95648,NLH,75,60,15,0.8,2022-23 WSOP Circuit Event (Northern California-Winter) - Satellite - Step Satellite into $300 Main Event Mega Satellite
1232,1/20/2023 6:00:00 pm,Thunder Valley Casino,95648,NLH,300,250,50,0.8333333333333334,2022-23 WSOP Circuit Event (Northern California-Winter) - Satellite - Mega Satellite into Main Event
1233,1/21/2023 9:00:00 am,Thunder Valley Casino,95648,NLH,300,250,50,0.8333333333333334,2022-23 WSOP Circuit Event (Northern California-Winter) - Satellite - Mega Satellite Turbo into Main Event
1234,1/21/2023 10:00:00 am,Capitol Casino,95811,NLH,100,85,15,0.85,$100 BUY-IN
1235,1/21/2023 11:00:00 am,Thunder Valley Casino,95648,NLH,1700,1515,185,0.8911764705882353,2022-23 WSOP Circuit Event (Northern California-Winter) - Event #11 - Main Event
1236,1/22/2023 9:00:00 am,Thunder Valley Casino,95648,NLH,190,165,25,0.868421052631579,2022-23 WSOP Circuit Event (Northern California-Winter) - Satellite - Mega Satellite into Event #12
1237,1/22/2023 10:00:00 am,Capitol Casino,95811,NLH,60,50,10,0.8333333333333334,$60 DOUBLE STACK
1238,1/22/2023 1:00:00 pm,Thunder Valley Casino,95648,NLH,1125,1000,125,0.8888888888888888,2022-23 WSOP Circuit Event (Northern California-Winter) - Event #12 - Eight Handed Knockout NLH
1239,1/23/2023 9:00:00 am,Thunder Valley Casino,95648,NLH,400,330,70,0.825,2022-23 WSOP Circuit Event (Northern California-Winter) - Event #13 - Series Finale NLH
1240,1/23/2023 10:00:00 am,Capitol Casino,95811,NLH,30,25,5,0.8333333333333334,$30 MONDAY NLH
1241,1/24/2023 9:30:00 am,Thunder Valley Casino,95648,NLH,75,58,17,0.7733333333333333,No-Limit Hold'em - Single Re-Entry
1242,1/24/2023 10:00:00 am,Capitol Casino,95811,NLH,30,25,5,0.8333333333333334,$30 TUESDAY DOUBLE RE-BUY
1243,1/25/2023 9:30:00 am,Thunder Valley Casino,95648,NLH,75,58,17,0.7733333333333333,No-Limit Hold'em - Single Re-Entry
1244,1/25/2023 10:00:00 am,Capitol Casino,95811,NLH,30,25,5,0.8333333333333334,$30 WEDNESDAY NLH
1245,1/26/2023 9:30:00 am,Thunder Valley Casino,95648,NLH,100,80,20,0.8,No-Limit Hold'em Knockout
1246,1/26/2023 10:00:00 am,Capitol Casino,95811,NLH,30,25,5,0.8333333333333334,$30 THURSDAY NLH
1247,1/27/2023 9:30:00 am,Thunder Valley Casino,95648,NLH,125,100,25,0.8,NLH w/ 1 $100 Rebuy - Big Blind Ante
1248,1/27/2023 10:00:00 am,Capitol Casino,95811,NLH,30,25,5,0.8333333333333334,$30 FRIDAY NLH
1249,1/28/2023 9:30:00 am,Thunder Valley Casino,95648,NLH,240,200,40,0.8333333333333334,NLH
1250,1/28/2023 10:00:00 am,Capitol Casino,95811,NLH,100,85,15,0.85,$100 BUY-IN
1251,1/29/2023 5:30:00 pm,Thunder Valley Casino,95648,NLH,150,123,27,0.82,NLH Knockout Bounty
1252,1/30/2023 9:30:00 am,Thunder Valley Casino,95648,NLH,75,58,17,0.7733333333333333,No-Limit Hold'em - Single Re-Entry
1253,1/31/2023 9:30:00 am,Thunder Valley Casino,95648,NLH,75,58,17,0.7733333333333333,No-Limit Hold'em - Single Re-Entry
1254,2/01/2023 9:30:00 am,Thunder Valley Casino,95648,NLH,75,58,17,0.7733333333333333,No-Limit Hold'em - Single Re-Entry
1255,2/02/2023 9:30:00 am,Thunder Valley Casino,95648,NLH,100,80,20,0.8,No-Limit Hold'em Knockout
1256,2/03/2023 9:30:00 am,Thunder Valley Casino,95648,NLH,125,100,25,0.8,NLH w/ 1 $100 Rebuy - Big Blind Ante
1257,2/04/2023 9:30:00 am,Thunder Valley Casino,95648,NLH,240,200,40,0.8333333333333334,NLH
1258,2/05/2023 5:30:00 pm,Thunder Valley Casino,95648,NLH,150,123,27,0.82,NLH Knockout Bounty
1259,2/06/2023 9:30:00 am,Thunder Valley Casino,95648,NLH,75,58,17,0.7733333333333333,No-Limit Hold'em - Single Re-Entry
1260,2/07/2023 9:30:00 am,Thunder Valley Casino,95648,NLH,75,58,17,0.7733333333333333,No-Limit Hold'em - Single Re-Entry
1261,2/08/2023 9:30:00 am,Thunder Valley Casino,95648,NLH,75,58,17,0.7733333333333333,No-Limit Hold'em - Single Re-Entry
1262,2/09/2023 9:30:00 am,Thunder Valley Casino,95648,NLH,100,80,20,0.8,No-Limit Hold'em Knockout
1263,2/10/2023 9:30:00 am,Thunder Valley Casino,95648,NLH,125,100,25,0.8,NLH w/ 1 $100 Rebuy - Big Blind Ante
1264,2/11/2023 9:30:00 am,Thunder Valley Casino,95648,NLH,240,200,40,0.8333333333333334,NLH
1265,2/12/2023 5:30:00 pm,Thunder Valley Casino,95648,NLH,150,123,27,0.82,NLH Knockout Bounty
1266,2/13/2023 9:30:00 am,Thunder Valley Casino,95648,NLH,75,58,17,0.7733333333333333,No-Limit Hold'em - Single Re-Entry
1267,2/14/2023 9:30:00 am,Thunder Valley Casino,95648,NLH,75,58,17,0.7733333333333333,No-Limit Hold'em - Single Re-Entry
1268,2/15/2023 9:30:00 am,Thunder Valley Casino,95648,NLH,75,58,17,0.7733333333333333,No-Limit Hold'em - Single Re-Entry
1269,2/16/2023 9:30:00 am,Thunder Valley Casino,95648,NLH,100,80,20,0.8,No-Limit Hold'em Knockout
1270,2/17/2023 9:30:00 am,Thunder Valley Casino,95648,NLH,125,100,25,0.8,NLH w/ 1 $100 Rebuy - Big Blind Ante
1271,2/18/2023 9:30:00 am,Thunder Valley Casino,95648,NLH,240,200,40,0.8333333333333334,NLH
1272,2/19/2023 5:30:00 pm,Thunder Valley Casino,95648,NLH,150,123,27,0.82,NLH Knockout Bounty
1273,2/20/2023 9:30:00 am,Thunder Valley Casino,95648,NLH,75,58,17,0.7733333333333333,No-Limit Hold'em - Single Re-Entry
1274,2/21/2023 9:30:00 am,Thunder Valley Casino,95648,NLH,75,58,17,0.7733333333333333,No-Limit Hold'em - Single Re-Entry
1275,2/22/2023 9:30:00 am,Thunder Valley Casino,95648,NLH,75,58,17,0.7733333333333333,No-Limit Hold'em - Single Re-Entry
1276,2/23/2023 9:30:00 am,Thunder Valley Casino,95648,NLH,100,80,20,0.8,No-Limit Hold'em Knockout
1277,2/24/2023 9:30:00 am,Thunder Valley Casino,95648,NLH,125,100,25,0.8,NLH w/ 1 $100 Rebuy - Big Blind Ante
1278,2/25/2023 9:30:00 am,Thunder Valley Casino,95648,NLH,240,200,40,0.8333333333333334,NLH
1279,2/26/2023 5:30:00 pm,Thunder Valley Casino,95648,NLH,150,123,27,0.82,NLH Knockout Bounty
1280,2/27/2023 9:30:00 am,Thunder Valley Casino,95648,NLH,75,58,17,0.7733333333333333,No-Limit Hold'em - Single Re-Entry
1281,2/28/2023 9:30:00 am,Thunder Valley Casino,95648,NLH,75,58,17,0.7733333333333333,No-Limit Hold'em - Single Re-Entry
1282,3/01/2023 9:30:00 am,Thunder Valley Casino,95648,NLH,75,58,17,0.7733333333333333,No-Limit Hold'em - Single Re-Entry
1283,3/02/2023 9:30:00 am,Thunder Valley Casino,95648,NLH,100,80,20,0.8,No-Limit Hold'em Knockout
1284,3/05/2023 5:30:00 pm,Thunder Valley Casino,95648,NLH,150,123,27,0.82,NLH Knockout Bounty
1285,3/06/2023 9:30:00 am,Thunder Valley Casino,95648,NLH,75,58,17,0.7733333333333333,No-Limit Hold'em - Single Re-Entry
1286,3/07/2023 9:30:00 am,Thunder Valley Casino,95648,NLH,75,58,17,0.7733333333333333,No-Limit Hold'em - Single Re-Entry
1287,3/08/2023 9:30:00 am,Thunder Valley Casino,95648,NLH,75,58,17,0.7733333333333333,No-Limit Hold'em - Single Re-Entry
1288,3/09/2023 9:30:00 am,Thunder Valley Casino,95648,NLH,100,80,20,0.8,No-Limit Hold'em Knockout
1289,3/10/2023 9:30:00 am,Thunder Valley Casino,95648,NLH,125,100,25,0.8,NLH w/ 1 $100 Rebuy - Big Blind Ante
1290,3/11/2023 9:30:00 am,Thunder Valley Casino,95648,NLH,240,200,40,0.8333333333333334,NLH
1291,3/12/2023 5:30:00 pm,Thunder Valley Casino,95648,NLH,150,123,27,0.82,NLH Knockout Bounty
1292,3/13/2023 9:30:00 am,Thunder Valley Casino,95648,NLH,75,58,17,0.7733333333333333,No-Limit Hold'em - Single Re-Entry
1293,3/14/2023 9:30:00 am,Thunder Valley Casino,95648,NLH,75,58,17,0.7733333333333333,No-Limit Hold'em - Single Re-Entry
1294,3/15/2023 9:30:00 am,Thunder Valley Casino,95648,NLH,75,58,17,0.7733333333333333,No-Limit Hold'em - Single Re-Entry
1295,1/14/2023 10:00:00 am,Jamul Casino,91935,NLH,40,25,15,0.625,NLH w/Single Rebuy & Add-On
1296,1/14/2023 10:00:00 am,Sycuan Casino,92019,NLH,265,222,43,0.8377358490566038,2023 MSPT Showdown Series - San Diego - Satellite - Satellite into $300K GTD Event #12
1297,1/14/2023 10:00:00 am,Sycuan Casino,92019,NLH,70,55,15,0.7857142857142857,NLH
1298,1/14/2023 10:00:00 am,Ocean's 11 Casino,92054,NLH,290,250,40,0.8620689655172413,WEEKEND NL TOURNAMENT
1299,1/14/2023 3:00:00 pm,Sycuan Casino,92019,NLH,1110,970,140,0.8738738738738738,2023 MSPT Showdown Series - San Diego - Event #12 - Main Event NLH
1300,1/14/2023 4:00:00 pm,Jamul Casino,91935,NLH,100,80,20,0.8,Helix $5K GTD Jack Your Stack
1301,1/14/2023 7:00:00 pm,Sycuan Casino,92019,NLH,135,100,35,0.7407407407407407,2023 MSPT Showdown Series - San Diego - Event #14 - Nightly NLH
1302,1/15/2023 10:00:00 am,Jamul Casino,91935,NLH,80,65,15,0.8125,NLH
1303,1/15/2023 10:00:00 am,Ocean's 11 Casino,92054,NLH,290,250,40,0.8620689655172413,WEEKEND NL TOURNAMENT
1304,1/15/2023 12:00:00 pm,Sycuan Casino,92019,NLH,250,200,50,0.8,2023 MSPT Showdown Series - San Diego - Event #15 - Black Chip Bounty NLH
1305,1/15/2023 3:00:00 pm,Sycuan Casino,92019,NLH,135,100,35,0.7407407407407407,2023 MSPT Showdown Series - San Diego - Event #16 - Last Chance NLH
1306,1/15/2023 6:00:00 pm,Jamul Casino,91935,NLH,125,110,15,0.88,Sunday Night Bounty
1307,1/16/2023 10:00:00 am,Jamul Casino,91935,NLH,60,45,15,0.75,NLH
1308,1/16/2023 10:00:00 am,Ocean's 11 Casino,92054,NLH,150,125,25,0.8333333333333334,MLK DAY NL BOUNTY TOURNAMENT
1309,1/16/2023 6:00:00 pm,Jamul Casino,91935,NLH,60,45,15,0.75,No-Limit Hold'em
1310,1/17/2023 10:00:00 am,Jamul Casino,91935,NLH,60,45,15,0.75,NLH
1311,1/17/2023 6:00:00 pm,Jamul Casino,91935,NLH,60,45,15,0.75,No-Limit Hold'em
1312,1/17/2023 6:30:00 pm,Sycuan Casino,92019,NLH,50,35,15,0.7,NLH
1313,1/18/2023 10:00:00 am,Jamul Casino,91935,NLH,60,45,15,0.75,NLH
1314,1/18/2023 6:30:00 pm,Sycuan Casino,92019,NLH,25,10,15,0.4,NLH
1315,1/19/2023 10:00:00 am,Jamul Casino,91935,NLH,60,45,15,0.75,NLH
1316,1/19/2023 6:00:00 pm,Jamul Casino,91935,NLH,60,45,15,0.75,No-Limit Hold'em
1317,1/19/2023 6:30:00 pm,Sycuan Casino,92019,NLH,50,35,15,0.7,NLH
1318,1/20/2023 10:00:00 am,Jamul Casino,91935,NLH,60,45,15,0.75,NLH
1319,1/20/2023 6:30:00 pm,Sycuan Casino,92019,NLH,25,10,15,0.4,NLH
1320,1/21/2023 10:00:00 am,Jamul Casino,91935,NLH,40,25,15,0.625,NLH w/Single Rebuy & Add-On
1321,1/21/2023 10:00:00 am,Ocean's 11 Casino,92054,NLH,290,250,40,0.8620689655172413,WEEKEND NL TOURNAMENT
1322,1/21/2023 4:00:00 pm,Jamul Casino,91935,NLH,100,80,20,0.8,NLH
1323,1/21/2023 6:00:00 pm,Sycuan Casino,92019,NLH,100,80,20,0.8,NLH Bounty
1324,1/22/2023 10:00:00 am,Jamul Casino,91935,NLH,80,65,15,0.8125,NLH
1325,1/22/2023 10:00:00 am,Ocean's 11 Casino,92054,NLH,290,250,40,0.8620689655172413,WEEKEND NL TOURNAMENT
1326,1/22/2023 6:00:00 pm,Jamul Casino,91935,NLH,125,110,15,0.88,Sunday Night Bounty
1327,1/22/2023 6:00:00 pm,Sycuan Casino,92019,NLH,25,10,15,0.4,NLH
1328,1/23/2023 10:00:00 am,Jamul Casino,91935,NLH,60,45,15,0.75,NLH
1329,1/23/2023 6:00:00 pm,Jamul Casino,91935,NLH,60,45,15,0.75,No-Limit Hold'em
1330,1/23/2023 6:30:00 pm,Sycuan Casino,92019,NLH,25,10,15,0.4,NLH
1331,1/24/2023 10:00:00 am,Jamul Casino,91935,NLH,60,45,15,0.75,NLH
1332,1/24/2023 6:00:00 pm,Jamul Casino,91935,NLH,60,45,15,0.75,No-Limit Hold'em
1333,1/24/2023 6:30:00 pm,Sycuan Casino,92019,NLH,50,35,15,0.7,NLH
1334,1/24/2023 7:00:00 pm,Ocean's 11 Casino,92054,NLH,95,75,20,0.7894736842105263,NIGHT OWL
1335,1/25/2023 10:00:00 am,Jamul Casino,91935,NLH,60,45,15,0.75,NLH
1336,1/25/2023 6:30:00 pm,Sycuan Casino,92019,NLH,25,10,15,0.4,NLH
1337,1/26/2023 10:00:00 am,Jamul Casino,91935,NLH,60,45,15,0.75,NLH
1338,1/26/2023 6:00:00 pm,Jamul Casino,91935,NLH,60,45,15,0.75,No-Limit Hold'em
1339,1/26/2023 6:30:00 pm,Sycuan Casino,92019,NLH,50,35,15,0.7,NLH
1340,1/27/2023 10:00:00 am,Jamul Casino,91935,NLH,60,45,15,0.75,NLH
1341,1/27/2023 6:30:00 pm,Sycuan Casino,92019,NLH,25,10,15,0.4,NLH
1342,1/28/2023 10:00:00 am,Jamul Casino,91935,NLH,40,25,15,0.625,NLH w/Single Rebuy & Add-On
1343,1/28/2023 10:00:00 am,Ocean's 11 Casino,92054,NLH,290,250,40,0.8620689655172413,WEEKEND NL TOURNAMENT
1344,1/28/2023 4:00:00 pm,Jamul Casino,91935,NLH,100,80,20,0.8,NLH
1345,1/28/2023 6:00:00 pm,Sycuan Casino,92019,NLH,100,80,20,0.8,NLH Bounty
1346,1/29/2023 10:00:00 am,Jamul Casino,91935,NLH,80,65,15,0.8125,NLH
1347,1/29/2023 10:00:00 am,Ocean's 11 Casino,92054,NLH,290,250,40,0.8620689655172413,WEEKEND NL TOURNAMENT
1348,1/29/2023 6:00:00 pm,Jamul Casino,91935,NLH,125,110,15,0.88,Sunday Night Bounty
1349,1/29/2023 6:00:00 pm,Sycuan Casino,92019,NLH,25,10,15,0.4,NLH
1350,1/30/2023 6:30:00 pm,Sycuan Casino,92019,NLH,25,10,15,0.4,NLH
1351,1/30/2023 7:00:00 pm,Ocean's 11 Casino,92054,NLH,95,75,20,0.7894736842105263,NIGHT OWL
1352,1/31/2023 6:30:00 pm,Sycuan Casino,92019,NLH,50,35,15,0.7,NLH
1353,2/01/2023 10:00:00 am,Jamul Casino,91935,NLH,60,45,15,0.75,NLH
1354,2/01/2023 6:30:00 pm,Sycuan Casino,92019,NLH,25,10,15,0.4,NLH
1355,2/02/2023 10:00:00 am,Jamul Casino,91935,NLH,60,45,15,0.75,NLH
1356,2/02/2023 6:00:00 pm,Jamul Casino,91935,NLH,60,45,15,0.75,No-Limit Hold'em
1357,2/02/2023 6:30:00 pm,Sycuan Casino,92019,NLH,50,35,15,0.7,NLH
1358,2/03/2023 10:00:00 am,Jamul Casino,91935,NLH,60,45,15,0.75,NLH
1359,2/03/2023 6:30:00 pm,Sycuan Casino,92019,NLH,25,10,15,0.4,NLH
1360,2/04/2023 10:00:00 am,Jamul Casino,91935,NLH,40,25,15,0.625,NLH w/Single Rebuy & Add-On
1361,2/04/2023 10:00:00 am,Ocean's 11 Casino,92054,NLH,290,250,40,0.8620689655172413,WEEKEND NL TOURNAMENT
1362,2/04/2023 4:00:00 pm,Jamul Casino,91935,NLH,100,80,20,0.8,NLH
1363,2/04/2023 6:00:00 pm,Sycuan Casino,92019,NLH,100,80,20,0.8,NLH Bounty
1364,2/05/2023 10:00:00 am,Jamul Casino,91935,NLH,80,65,15,0.8125,NLH
1365,2/05/2023 10:00:00 am,Ocean's 11 Casino,92054,NLH,290,250,40,0.8620689655172413,WEEKEND NL TOURNAMENT
1366,2/05/2023 6:00:00 pm,Jamul Casino,91935,NLH,125,110,15,0.88,Sunday Night Bounty
1367,2/05/2023 6:00:00 pm,Sycuan Casino,92019,NLH,25,10,15,0.4,NLH
1368,2/06/2023 10:00:00 am,Jamul Casino,91935,NLH,60,45,15,0.75,NLH
1369,2/06/2023 6:00:00 pm,Jamul Casino,91935,NLH,60,45,15,0.75,No-Limit Hold'em
1370,2/06/2023 6:30:00 pm,Sycuan Casino,92019,NLH,25,10,15,0.4,NLH
1371,2/07/2023 10:00:00 am,Jamul Casino,91935,NLH,60,45,15,0.75,NLH
1372,2/07/2023 6:00:00 pm,Jamul Casino,91935,NLH,60,45,15,0.75,No-Limit Hold'em
1373,2/07/2023 6:30:00 pm,Sycuan Casino,92019,NLH,50,35,15,0.7,NLH
1374,2/08/2023 10:00:00 am,Jamul Casino,91935,NLH,60,45,15,0.75,NLH
1375,2/08/2023 6:30:00 pm,Sycuan Casino,92019,NLH,25,10,15,0.4,NLH
1376,2/09/2023 10:00:00 am,Jamul Casino,91935,NLH,60,45,15,0.75,NLH
1377,2/09/2023 6:00:00 pm,Jamul Casino,91935,NLH,60,45,15,0.75,No-Limit Hold'em
1378,2/09/2023 6:30:00 pm,Sycuan Casino,92019,NLH,50,35,15,0.7,NLH
1379,2/10/2023 10:00:00 am,Jamul Casino,91935,NLH,60,45,15,0.75,NLH
1380,2/10/2023 6:30:00 pm,Sycuan Casino,92019,NLH,25,10,15,0.4,NLH
1381,2/11/2023 10:00:00 am,Jamul Casino,91935,NLH,40,25,15,0.625,NLH w/Single Rebuy & Add-On
1382,2/11/2023 10:00:00 am,Ocean's 11 Casino,92054,NLH,290,250,40,0.8620689655172413,WEEKEND NL TOURNAMENT
1383,2/11/2023 4:00:00 pm,Jamul Casino,91935,NLH,100,80,20,0.8,Helix $5K GTD Jack Your Stack
1384,2/11/2023 6:00:00 pm,Sycuan Casino,92019,NLH,100,80,20,0.8,NLH Bounty
1385,2/12/2023 10:00:00 am,Jamul Casino,91935,NLH,80,65,15,0.8125,NLH
1386,2/12/2023 6:00:00 pm,Jamul Casino,91935,NLH,125,110,15,0.88,Sunday Night Bounty
1387,2/12/2023 6:00:00 pm,Sycuan Casino,92019,NLH,25,10,15,0.4,NLH
1388,2/13/2023 10:00:00 am,Jamul Casino,91935,NLH,60,45,15,0.75,NLH
1389,2/13/2023 6:00:00 pm,Jamul Casino,91935,NLH,60,45,15,0.75,No-Limit Hold'em
1390,2/13/2023 6:30:00 pm,Sycuan Casino,92019,NLH,25,10,15,0.4,NLH
1391,2/14/2023 10:00:00 am,Jamul Casino,91935,NLH,60,45,15,0.75,NLH
1392,2/14/2023 6:00:00 pm,Jamul Casino,91935,NLH,60,45,15,0.75,No-Limit Hold'em
1393,2/14/2023 6:30:00 pm,Sycuan Casino,92019,NLH,50,35,15,0.7,NLH
1394,2/15/2023 10:00:00 am,Jamul Casino,91935,NLH,60,45,15,0.75,NLH
1395,2/15/2023 6:30:00 pm,Sycuan Casino,92019,NLH,25,10,15,0.4,NLH
1396,2/16/2023 10:00:00 am,Jamul Casino,91935,NLH,60,45,15,0.75,NLH
1397,2/16/2023 6:00:00 pm,Jamul Casino,91935,NLH,60,45,15,0.75,No-Limit Hold'em
1398,2/16/2023 6:30:00 pm,Sycuan Casino,92019,NLH,50,35,15,0.7,NLH
1399,2/17/2023 10:00:00 am,Jamul Casino,91935,NLH,60,45,15,0.75,NLH
1400,2/17/2023 6:30:00 pm,Sycuan Casino,92019,NLH,25,10,15,0.4,NLH
1401,2/18/2023 10:00:00 am,Jamul Casino,91935,NLH,40,25,15,0.625,NLH w/Single Rebuy & Add-On
1402,2/18/2023 4:00:00 pm,Jamul Casino,91935,NLH,100,80,20,0.8,NLH
1403,2/18/2023 6:00:00 pm,Sycuan Casino,92019,NLH,100,80,20,0.8,NLH Bounty
1404,2/19/2023 10:00:00 am,Jamul Casino,91935,NLH,80,65,15,0.8125,NLH
1405,2/19/2023 6:00:00 pm,Jamul Casino,91935,NLH,125,110,15,0.88,Sunday Night Bounty
1406,2/19/2023 6:00:00 pm,Sycuan Casino,92019,NLH,25,10,15,0.4,NLH
1407,2/20/2023 10:00:00 am,Jamul Casino,91935,NLH,60,45,15,0.75,NLH
1408,2/20/2023 6:00:00 pm,Jamul Casino,91935,NLH,60,45,15,0.75,No-Limit Hold'em
1409,2/20/2023 6:30:00 pm,Sycuan Casino,92019,NLH,25,10,15,0.4,NLH
1410,2/21/2023 10:00:00 am,Jamul Casino,91935,NLH,60,45,15,0.75,NLH
1411,2/21/2023 6:00:00 pm,Jamul Casino,91935,NLH,60,45,15,0.75,No-Limit Hold'em
1412,2/21/2023 6:30:00 pm,Sycuan Casino,92019,NLH,50,35,15,0.7,NLH
1413,2/22/2023 10:00:00 am,Jamul Casino,91935,NLH,60,45,15,0.75,NLH
1414,2/22/2023 6:30:00 pm,Sycuan Casino,92019,NLH,25,10,15,0.4,NLH
1415,2/23/2023 10:00:00 am,Jamul Casino,91935,NLH,60,45,15,0.75,NLH
1416,2/23/2023 6:00:00 pm,Jamul Casino,91935,NLH,60,45,15,0.75,No-Limit Hold'em
1417,2/23/2023 6:30:00 pm,Sycuan Casino,92019,NLH,50,35,15,0.7,NLH
1418,2/24/2023 10:00:00 am,Jamul Casino,91935,NLH,60,45,15,0.75,NLH
1419,2/24/2023 6:30:00 pm,Sycuan Casino,92019,NLH,25,10,15,0.4,NLH
1420,2/25/2023 10:00:00 am,Jamul Casino,91935,NLH,40,25,15,0.625,NLH w/Single Rebuy & Add-On
1421,2/25/2023 4:00:00 pm,Jamul Casino,91935,NLH,100,80,20,0.8,NLH
1422,2/25/2023 6:00:00 pm,Sycuan Casino,92019,NLH,100,80,20,0.8,NLH Bounty
1423,2/26/2023 10:00:00 am,Jamul Casino,91935,NLH,80,65,15,0.8125,NLH
1424,2/26/2023 6:00:00 pm,Jamul Casino,91935,NLH,125,110,15,0.88,Sunday Night Bounty
1425,2/26/2023 6:00:00 pm,Sycuan Casino,92019,NLH,25,10,15,0.4,NLH
1426,2/27/2023 10:00:00 am,Jamul Casino,91935,NLH,60,45,15,0.75,NLH
1427,2/27/2023 6:00:00 pm,Jamul Casino,91935,NLH,60,45,15,0.75,No-Limit Hold'em
1428,2/27/2023 6:30:00 pm,Sycuan Casino,92019,NLH,25,10,15,0.4,NLH
1429,2/28/2023 10:00:00 am,Jamul Casino,91935,NLH,60,45,15,0.75,NLH
1430,2/28/2023 6:00:00 pm,Jamul Casino,91935,NLH,60,45,15,0.75,No-Limit Hold'em
1431,2/28/2023 6:30:00 pm,Sycuan Casino,92019,NLH,50,35,15,0.7,NLH
1432,3/01/2023 10:00:00 am,Jamul Casino,91935,NLH,60,45,15,0.75,NLH
1433,3/01/2023 6:30:00 pm,Sycuan Casino,92019,NLH,25,10,15,0.4,NLH
1434,3/02/2023 10:00:00 am,Jamul Casino,91935,NLH,60,45,15,0.75,NLH
1435,3/02/2023 6:00:00 pm,Jamul Casino,91935,NLH,60,45,15,0.75,No-Limit Hold'em
1436,3/02/2023 6:30:00 pm,Sycuan Casino,92019,NLH,50,35,15,0.7,NLH
1437,3/03/2023 10:00:00 am,Jamul Casino,91935,NLH,60,45,15,0.75,NLH
1438,3/03/2023 6:30:00 pm,Sycuan Casino,92019,NLH,25,10,15,0.4,NLH
1439,3/04/2023 10:00:00 am,Jamul Casino,91935,NLH,40,25,15,0.625,NLH w/Single Rebuy & Add-On
1440,3/04/2023 6:00:00 pm,Sycuan Casino,92019,NLH,100,80,20,0.8,NLH Bounty
1441,3/05/2023 10:00:00 am,Jamul Casino,91935,NLH,80,65,15,0.8125,NLH
1442,3/05/2023 6:00:00 pm,Jamul Casino,91935,NLH,125,110,15,0.88,Sunday Night Bounty
1443,3/05/2023 6:00:00 pm,Sycuan Casino,92019,NLH,25,10,15,0.4,NLH
1444,3/06/2023 10:00:00 am,Jamul Casino,91935,NLH,60,45,15,0.75,NLH
1445,3/06/2023 6:00:00 pm,Jamul Casino,91935,NLH,60,45,15,0.75,No-Limit Hold'em
1446,3/06/2023 6:30:00 pm,Sycuan Casino,92019,NLH,25,10,15,0.4,NLH
1447,3/07/2023 10:00:00 am,Jamul Casino,91935,NLH,60,45,15,0.75,NLH
1448,3/07/2023 6:00:00 pm,Jamul Casino,91935,NLH,60,45,15,0.75,No-Limit Hold'em
1449,3/07/2023 6:30:00 pm,Sycuan Casino,92019,NLH,50,35,15,0.7,NLH
1450,3/08/2023 10:00:00 am,Jamul Casino,91935,NLH,60,45,15,0.75,NLH
1451,3/08/2023 6:30:00 pm,Sycuan Casino,92019,NLH,25,10,15,0.4,NLH
1452,3/09/2023 10:00:00 am,Jamul Casino,91935,NLH,60,45,15,0.75,NLH
1453,3/09/2023 6:00:00 pm,Jamul Casino,91935,NLH,60,45,15,0.75,No-Limit Hold'em
1454,3/09/2023 6:30:00 pm,Sycuan Casino,92019,NLH,50,35,15,0.7,NLH
1455,3/10/2023 10:00:00 am,Jamul Casino,91935,NLH,60,45,15,0.75,NLH
1456,3/10/2023 6:30:00 pm,Sycuan Casino,92019,NLH,25,10,15,0.4,NLH
1457,3/11/2023 10:00:00 am,Jamul Casino,91935,NLH,40,25,15,0.625,NLH w/Single Rebuy & Add-On
1458,3/11/2023 4:00:00 pm,Jamul Casino,91935,NLH,100,80,20,0.8,Helix $5K GTD Jack Your Stack
1459,3/11/2023 6:00:00 pm,Sycuan Casino,92019,NLH,100,80,20,0.8,NLH Bounty
1460,3/12/2023 10:00:00 am,Jamul Casino,91935,NLH,80,65,15,0.8125,NLH
1461,3/12/2023 6:00:00 pm,Jamul Casino,91935,NLH,125,110,15,0.88,Sunday Night Bounty
1462,3/12/2023 6:00:00 pm,Sycuan Casino,92019,NLH,25,10,15,0.4,NLH
1463,3/13/2023 10:00:00 am,Jamul Casino,91935,NLH,60,45,15,0.75,NLH
1464,3/13/2023 6:00:00 pm,Jamul Casino,91935,NLH,60,45,15,0.75,No-Limit Hold'em
1465,3/13/2023 6:30:00 pm,Sycuan Casino,92019,NLH,25,10,15,0.4,NLH
1466,3/14/2023 10:00:00 am,Jamul Casino,91935,NLH,60,45,15,0.75,NLH
1467,3/14/2023 6:00:00 pm,Jamul Casino,91935,NLH,60,45,15,0.75,No-Limit Hold'em
1468,3/14/2023 6:30:00 pm,Sycuan Casino,92019,NLH,50,35,15,0.7,NLH
1469,3/15/2023 10:00:00 am,Jamul Casino,91935,NLH,60,45,15,0.75,NLH
1470,1/14/2023 12:00:00 pm,Ace & Vine,94558,NLH,240,200,40,0.8333333333333334,Saturday NLH Tournament
1471,1/15/2023 9:00:00 am,Livermore Casino,94551,NLH,240,200,40,0.8333333333333334,Sunday Morning Showdown NLH
1472,1/15/2023 9:30:00 am,Lucky Chances Casino,94014,NLH,300,250,50,0.8333333333333334,No Limit Hold'em
1473,1/15/2023 10:00:00 am,Graton Resort & Casino,94928,NLH,250,190,60,0.76,NLH
1474,1/15/2023 4:00:00 pm,Pete's 881 Club,94901,NLH,220,200,20,0.9090909090909092,NLH
1475,1/16/2023 9:15:00 am,Bay 101 Casino,95112,NLH,200,165,35,0.825,NLH
1476,1/16/2023 10:00:00 am,Graton Resort & Casino,94928,NLH,135,100,35,0.7407407407407407,NLH
1477,1/17/2023 9:15:00 am,Bay 101 Casino,95112,NLH,200,165,35,0.825,NLH
1478,1/17/2023 6:00:00 pm,Graton Resort & Casino,94928,NLH,165,125,40,0.7575757575757576,NLH Bounty
1479,1/17/2023 6:00:00 pm,Ace & Vine,94558,NLH,240,200,40,0.8333333333333334,Evening NLH Tournament
1480,1/18/2023 9:15:00 am,Bay 101 Casino,95112,NLH,200,165,35,0.825,NLH
1481,1/18/2023 9:30:00 am,Lucky Chances Casino,94014,NLH,180,140,40,0.7777777777777778,No Limit Hold'em
1482,1/18/2023 10:00:00 am,Graton Resort & Casino,94928,NLH,135,100,35,0.7407407407407407,NLH
1483,1/18/2023 10:00:00 am,Ace & Vine,94558,NLH,120,100,20,0.8333333333333334,Morning NLH Tournament
1484,1/19/2023 9:15:00 am,Bay 101 Casino,95112,NLH,200,165,35,0.825,NLH
1485,1/19/2023 6:00:00 pm,Graton Resort & Casino,94928,NLH,165,125,40,0.7575757575757576,NLH Bounty
1486,1/20/2023 9:30:00 am,Lucky Chances Casino,94014,NLH,240,200,40,0.8333333333333334,No Limit Hold'em
1487,1/20/2023 10:00:00 am,Graton Resort & Casino,94928,NLH,135,100,35,0.7407407407407407,NLH
1488,1/21/2023 12:00:00 pm,Ace & Vine,94558,NLH,240,200,40,0.8333333333333334,Saturday NLH Tournament
1489,1/22/2023 9:00:00 am,Livermore Casino,94551,NLH,240,200,40,0.8333333333333334,Sunday Morning Showdown NLH
1490,1/22/2023 9:30:00 am,Lucky Chances Casino,94014,NLH,300,250,50,0.8333333333333334,No Limit Hold'em
1491,1/22/2023 10:00:00 am,Graton Resort & Casino,94928,NLH,250,190,60,0.76,NLH
1492,1/22/2023 4:00:00 pm,Pete's 881 Club,94901,NLH,220,200,20,0.9090909090909092,NLH
1493,1/23/2023 9:15:00 am,Bay 101 Casino,95112,NLH,200,165,35,0.825,NLH
1494,1/23/2023 10:00:00 am,Graton Resort & Casino,94928,NLH,135,100,35,0.7407407407407407,NLH
1495,1/24/2023 9:15:00 am,Bay 101 Casino,95112,NLH,200,165,35,0.825,NLH
1496,1/24/2023 6:00:00 pm,Graton Resort & Casino,94928,NLH,165,125,40,0.7575757575757576,NLH Bounty
1497,1/24/2023 6:00:00 pm,Ace & Vine,94558,NLH,240,200,40,0.8333333333333334,Evening NLH Tournament
1498,1/25/2023 9:15:00 am,Bay 101 Casino,95112,NLH,200,165,35,0.825,NLH
1499,1/25/2023 9:30:00 am,Lucky Chances Casino,94014,NLH,180,140,40,0.7777777777777778,No Limit Hold'em
1500,1/25/2023 10:00:00 am,Graton Resort & Casino,94928,NLH,135,100,35,0.7407407407407407,NLH
1501,1/25/2023 10:00:00 am,Ace & Vine,94558,NLH,120,100,20,0.8333333333333334,Morning NLH Tournament
1502,1/26/2023 9:15:00 am,Bay 101 Casino,95112,NLH,200,165,35,0.825,NLH
1503,1/26/2023 6:00:00 pm,Graton Resort & Casino,94928,NLH,165,125,40,0.7575757575757576,NLH Bounty
1504,1/27/2023 9:30:00 am,Lucky Chances Casino,94014,NLH,240,200,40,0.8333333333333334,No Limit Hold'em
1505,1/27/2023 10:00:00 am,Graton Resort & Casino,94928,NLH,135,100,35,0.7407407407407407,NLH
1506,1/28/2023 12:00:00 pm,Ace & Vine,94558,NLH,240,200,40,0.8333333333333334,Saturday NLH Tournament
1507,1/29/2023 9:00:00 am,Livermore Casino,94551,NLH,240,200,40,0.8333333333333334,Sunday Morning Showdown NLH
1508,1/29/2023 9:30:00 am,Lucky Chances Casino,94014,NLH,300,250,50,0.8333333333333334,No Limit Hold'em
1509,1/29/2023 10:00:00 am,Graton Resort & Casino,94928,NLH,250,190,60,0.76,NLH
1510,1/29/2023 4:00:00 pm,Pete's 881 Club,94901,NLH,220,200,20,0.9090909090909092,NLH
1511,1/30/2023 9:15:00 am,Bay 101 Casino,95112,NLH,200,165,35,0.825,NLH
1512,1/30/2023 10:00:00 am,Graton Resort & Casino,94928,NLH,135,100,35,0.7407407407407407,NLH
1513,1/31/2023 9:15:00 am,Bay 101 Casino,95112,NLH,200,165,35,0.825,NLH
1514,1/31/2023 6:00:00 pm,Graton Resort & Casino,94928,NLH,165,125,40,0.7575757575757576,NLH Bounty
1515,1/31/2023 6:00:00 pm,Ace & Vine,94558,NLH,240,200,40,0.8333333333333334,Evening NLH Tournament
1516,2/01/2023 9:15:00 am,Bay 101 Casino,95112,NLH,200,165,35,0.825,NLH
1517,2/01/2023 9:30:00 am,Lucky Chances Casino,94014,NLH,180,140,40,0.7777777777777778,No Limit Hold'em
1518,2/01/2023 10:00:00 am,Graton Resort & Casino,94928,NLH,135,100,35,0.7407407407407407,NLH
1519,2/02/2023 9:15:00 am,Bay 101 Casino,95112,NLH,200,165,35,0.825,NLH
1520,2/02/2023 6:00:00 pm,Graton Resort & Casino,94928,NLH,165,125,40,0.7575757575757576,NLH Bounty
1521,2/03/2023 9:30:00 am,Lucky Chances Casino,94014,NLH,240,200,40,0.8333333333333334,No Limit Hold'em
1522,2/03/2023 10:00:00 am,Graton Resort & Casino,94928,NLH,135,100,35,0.7407407407407407,NLH
1523,2/05/2023 9:00:00 am,Livermore Casino,94551,NLH,240,200,40,0.8333333333333334,Sunday Morning Showdown NLH
1524,2/05/2023 9:30:00 am,Lucky Chances Casino,94014,NLH,300,250,50,0.8333333333333334,No Limit Hold'em
1525,2/05/2023 10:00:00 am,Graton Resort & Casino,94928,NLH,250,190,60,0.76,NLH
1526,2/05/2023 4:00:00 pm,Pete's 881 Club,94901,NLH,220,200,20,0.9090909090909092,NLH
1527,2/06/2023 9:15:00 am,Bay 101 Casino,95112,NLH,200,165,35,0.825,NLH
1528,2/06/2023 10:00:00 am,Graton Resort & Casino,94928,NLH,135,100,35,0.7407407407407407,NLH
1529,2/07/2023 9:15:00 am,Bay 101 Casino,95112,NLH,200,165,35,0.825,NLH
1530,1/14/2023 10:00:00 am,Bally's Black Hawk Casino,80422,NLH,80,60,20,0.75,No-Limit Hold'em Turbo
1531,1/14/2023 12:00:00 pm,Bally's Black Hawk Casino,80422,NLH,300,250,50,0.8333333333333334,No Limit Hold'em Deepstack
1532,1/14/2023 7:00:00 pm,Bally's Black Hawk Casino,80422,NLH,140,105,35,0.75,No-Limit Hold'em
1533,1/15/2023 10:00:00 am,Bally's Black Hawk Casino,80422,NLH,80,60,20,0.75,No-Limit Hold'em Turbo
1534,1/15/2023 12:00:00 pm,Bally's Black Hawk Casino,80422,NLH,200,160,40,0.8,No Limit Hold'em Deepstack
1535,1/15/2023 7:00:00 pm,Bally's Black Hawk Casino,80422,NLH,140,105,35,0.75,No-Limit Hold'em
1536,1/16/2023 10:00:00 am,Bally's Black Hawk Casino,80422,NLH,80,60,20,0.75,No-Limit Hold'em Turbo
1537,1/16/2023 12:00:00 pm,Bally's Black Hawk Casino,80422,NLH,100,80,20,0.8,No Limit Hold'em
1538,1/16/2023 7:00:00 pm,Bally's Black Hawk Casino,80422,NLH,80,60,20,0.75,No-Limit Hold'em Turbo
1539,1/17/2023 10:00:00 am,Bally's Black Hawk Casino,80422,NLH,80,60,20,0.75,No-Limit Hold'em Turbo
1540,1/17/2023 12:00:00 pm,Bally's Black Hawk Casino,80422,NLH,100,80,20,0.8,No Limit Hold'em
1541,1/17/2023 7:00:00 pm,Bally's Black Hawk Casino,80422,NLH,80,60,20,0.75,No-Limit Hold'em Turbo
1542,1/18/2023 10:00:00 am,Bally's Black Hawk Casino,80422,NLH,80,60,20,0.75,2023 MSPT Showdown Series - Black Hawk - Satellite - Satellite into Event 1
1543,1/18/2023 12:00:00 pm,Bally's Black Hawk Casino,80422,NLH,360,300,60,0.8333333333333334,2023 MSPT Showdown Series - Black Hawk - Event #1 - No Limit Hold'em
1544,1/18/2023 7:00:00 pm,Bally's Black Hawk Casino,80422,NLH,80,60,20,0.75,2023 MSPT Showdown Series - Black Hawk - Satellite - Satellite into Event 1
1545,1/19/2023 10:00:00 am,Bally's Black Hawk Casino,80422,NLH,80,60,20,0.75,2023 MSPT Showdown Series - Black Hawk - Satellite - Satellite into Event 1
1546,1/19/2023 12:00:00 pm,Bally's Black Hawk Casino,80422,NLH,360,300,60,0.8333333333333334,2023 MSPT Showdown Series - Black Hawk - Event #1 - No Limit Hold'em
1547,1/19/2023 7:00:00 pm,Bally's Black Hawk Casino,80422,NLH,135,100,35,0.7407407407407407,2023 MSPT Showdown Series - Black Hawk - Side Event - Nightly No Limit Hold'em
1548,1/20/2023 10:00:00 am,Bally's Black Hawk Casino,80422,NLH,80,60,20,0.75,2023 MSPT Showdown Series - Black Hawk - Satellite - Satellite into Event 1
1549,1/20/2023 12:00:00 pm,Bally's Black Hawk Casino,80422,NLH,360,300,60,0.8333333333333334,2023 MSPT Showdown Series - Black Hawk - Event #1 - No Limit Hold'em
1550,1/20/2023 7:00:00 pm,Bally's Black Hawk Casino,80422,NLH,135,100,35,0.7407407407407407,2023 MSPT Showdown Series - Black Hawk - Side Event - Nightly No Limit Hold'em
1551,1/21/2023 10:00:00 am,Bally's Black Hawk Casino,80422,NLH,80,60,20,0.75,2023 MSPT Showdown Series - Black Hawk - Satellite - Super Turbo Ironman Satellite into Event 1
1552,1/21/2023 12:00:00 pm,Bally's Black Hawk Casino,80422,NLH,360,300,60,0.8333333333333334,2023 MSPT Showdown Series - Black Hawk - Event #1 - No Limit Hold'em
1553,1/14/2023 11:00:00 am,Mohegan Sun,6382,NLH,150,125,25,0.8333333333333334,NLH w/Dealer Add-On
1554,1/14/2023 11:15:00 am,MGM Springfield,1103,NLH,250,205,45,0.82,NLH
1555,1/14/2023 1:00:00 pm,Lakes Region Casino,3220,NLH,100,100,"0% of buy-in extracted for charity, per state law.",1.0,NLH with Single Rebuy/Add-On
1556,1/14/2023 1:00:00 pm,Manchester Poker Room,3103,NLH,240,191,49,0.7958333333333333,SATURDAY $250
1557,1/14/2023 6:30:00 pm,Northwoods Casino,98264,NLH,40,40,"0% of buy-in extracted for charity, per state law.",1.0,Bounty
1558,1/15/2023 11:00:00 am,Mohegan Sun,6382,NLH,250,220,30,0.88,Black Chip Bounty NLH
1559,1/15/2023 11:10:00 am,Foxwoods Casino,6338,NLH,360,306,54,0.85,NLH
1560,1/15/2023 1:00:00 pm,Dover Poker Room & Casino,3820,NLH,90,71,19,0.7888888888888889,SUNDAY $90
1561,1/16/2023 10:00:00 am,Mohegan Sun,6382,NLH,150,125,25,0.8333333333333334,NLH w/Dealer Add-On
1562,1/17/2023 10:10:00 am,Foxwoods Casino,6338,NLH,160,130,30,0.8125,NLH w/Re-Entries
1563,1/17/2023 11:15:00 am,MGM Springfield,1103,NLH,150,115,35,0.7666666666666667,NLH
1564,1/17/2023 6:00:00 pm,Mohegan Sun,6382,NLH,150,125,25,0.8333333333333334,NLH w/Dealer Add-On
1565,1/17/2023 6:15:00 pm,MGM Springfield,1103,NLH,180,150,30,0.8333333333333334,"Survivor ($1,500 payouts)"
1566,1/18/2023 4:10:00 pm,Foxwoods Casino,6338,NLH,260,218,42,0.8384615384615385,NLH w/Re-Entries
1567,1/18/2023 5:00:00 pm,Lakes Region Casino,3220,NLH,90,90,"0% of buy-in extracted for charity, per state law.",1.0,No Rebuy
1568,1/18/2023 6:30:00 pm,Northwoods Casino,98264,NLH,40,40,"0% of buy-in extracted for charity, per state law.",1.0,Bounty
1569,1/19/2023 6:00:00 pm,Mohegan Sun,6382,NLH,150,125,25,0.8333333333333334,NLH w/Dealer Add-On
1570,1/19/2023 6:30:00 pm,Northwoods Casino,98264,NLH,30,30,"0% of buy-in extracted for charity, per state law.",1.0,No Rebuy
1571,1/20/2023 11:00:00 am,Mohegan Sun,6382,NLH,200,170,30,0.85,NLH w/Dealer Add-On
1572,1/20/2023 5:30:00 pm,Dover Poker Room & Casino,3820,NLH,140,129,11,0.9214285714285714,FRIDAY $140
1573,1/20/2023 6:00:00 pm,Lakes Region Casino,3220,NLH,150,150,"0% of buy-in extracted for charity, per state law.",1.0,Turbo
1574,1/20/2023 6:30:00 pm,Northwoods Casino,98264,NLH,30,30,"0% of buy-in extracted for charity, per state law.",1.0,No Rebuy
1575,1/21/2023 11:00:00 am,Mohegan Sun,6382,NLH,150,125,25,0.8333333333333334,NLH w/Dealer Add-On
1576,1/21/2023 11:15:00 am,MGM Springfield,1103,NLH,250,205,45,0.82,NLH
1577,1/21/2023 1:00:00 pm,Lakes Region Casino,3220,NLH,90,90,"0% of buy-in extracted for charity, per state law.",1.0,No Rebuy
1578,1/21/2023 1:00:00 pm,Manchester Poker Room,3103,NLH,150,119,31,0.7933333333333333,$150
1579,1/21/2023 6:30:00 pm,Northwoods Casino,98264,NLH,40,40,"0% of buy-in extracted for charity, per state law.",1.0,Bounty
1580,1/22/2023 11:00:00 am,Mohegan Sun,6382,NLH,250,220,30,0.88,Black Chip Bounty NLH
1581,1/22/2023 11:10:00 am,Foxwoods Casino,6338,NLH,360,306,54,0.85,NLH
1582,1/22/2023 1:00:00 pm,Dover Poker Room & Casino,3820,NLH,90,71,19,0.7888888888888889,SUNDAY $90
1583,1/23/2023 10:00:00 am,Mohegan Sun,6382,NLH,150,125,25,0.8333333333333334,NLH w/Dealer Add-On
1584,1/24/2023 10:10:00 am,Foxwoods Casino,6338,NLH,160,130,30,0.8125,NLH w/Re-Entries
1585,1/24/2023 11:15:00 am,MGM Springfield,1103,NLH,150,115,35,0.7666666666666667,NLH
1586,1/24/2023 6:00:00 pm,Mohegan Sun,6382,NLH,150,125,25,0.8333333333333334,NLH w/Dealer Add-On
1587,1/24/2023 6:15:00 pm,MGM Springfield,1103,NLH,180,150,30,0.8333333333333334,"Survivor ($1,500 payouts)"
1588,1/25/2023 4:10:00 pm,Foxwoods Casino,6338,NLH,260,218,42,0.8384615384615385,NLH w/Re-Entries
1589,1/25/2023 5:00:00 pm,Lakes Region Casino,3220,NLH,90,90,"0% of buy-in extracted for charity, per state law.",1.0,No Rebuy
1590,1/25/2023 6:30:00 pm,Northwoods Casino,98264,NLH,40,40,"0% of buy-in extracted for charity, per state law.",1.0,Bounty
1591,1/26/2023 6:00:00 pm,Mohegan Sun,6382,NLH,150,125,25,0.8333333333333334,NLH w/Dealer Add-On
1592,1/26/2023 6:30:00 pm,Northwoods Casino,98264,NLH,30,30,"0% of buy-in extracted for charity, per state law.",1.0,No Rebuy
1593,1/27/2023 11:00:00 am,Mohegan Sun,6382,NLH,200,170,30,0.85,NLH w/Dealer Add-On
1594,1/27/2023 5:30:00 pm,Dover Poker Room & Casino,3820,NLH,140,129,11,0.9214285714285714,FRIDAY $140
1595,1/27/2023 6:00:00 pm,Lakes Region Casino,3220,NLH,150,150,"0% of buy-in extracted for charity, per state law.",1.0,Turbo
1596,1/27/2023 6:30:00 pm,Northwoods Casino,98264,NLH,30,30,"0% of buy-in extracted for charity, per state law.",1.0,No Rebuy
1597,1/28/2023 11:00:00 am,Mohegan Sun,6382,NLH,150,125,25,0.8333333333333334,NLH w/Dealer Add-On
1598,1/28/2023 11:15:00 am,MGM Springfield,1103,NLH,250,205,45,0.82,NLH
1599,1/28/2023 1:00:00 pm,Lakes Region Casino,3220,NLH,100,100,"0% of buy-in extracted for charity, per state law.",1.0,NLH with Single Rebuy/Add-On
1600,1/28/2023 1:00:00 pm,Manchester Poker Room,3103,NLH,240,191,49,0.7958333333333333,SATURDAY $250
1601,1/28/2023 6:30:00 pm,Northwoods Casino,98264,NLH,40,40,"0% of buy-in extracted for charity, per state law.",1.0,Bounty
1602,1/29/2023 11:00:00 am,Mohegan Sun,6382,NLH,250,220,30,0.88,Black Chip Bounty NLH
1603,1/29/2023 11:10:00 am,Foxwoods Casino,6338,NLH,360,306,54,0.85,NLH
1604,1/29/2023 1:00:00 pm,Dover Poker Room & Casino,3820,NLH,90,71,19,0.7888888888888889,SUNDAY $90
1605,1/30/2023 10:00:00 am,Mohegan Sun,6382,NLH,150,125,25,0.8333333333333334,NLH w/Dealer Add-On
1606,1/31/2023 10:10:00 am,Foxwoods Casino,6338,NLH,160,130,30,0.8125,NLH w/Re-Entries
1607,1/31/2023 11:15:00 am,MGM Springfield,1103,NLH,150,115,35,0.7666666666666667,NLH
1608,1/31/2023 6:00:00 pm,Mohegan Sun,6382,NLH,150,125,25,0.8333333333333334,NLH w/Dealer Add-On
1609,1/31/2023 6:15:00 pm,MGM Springfield,1103,NLH,180,150,30,0.8333333333333334,"Survivor ($1,500 payouts)"
1610,2/01/2023 4:10:00 pm,Foxwoods Casino,6338,NLH,260,218,42,0.8384615384615385,NLH w/Re-Entries
1611,2/01/2023 5:00:00 pm,Lakes Region Casino,3220,NLH,90,90,"0% of buy-in extracted for charity, per state law.",1.0,No Rebuy
1612,2/01/2023 6:30:00 pm,Northwoods Casino,98264,NLH,40,40,"0% of buy-in extracted for charity, per state law.",1.0,Bounty
1613,2/02/2023 6:00:00 pm,Mohegan Sun,6382,NLH,150,125,25,0.8333333333333334,NLH w/Dealer Add-On
1614,2/02/2023 6:30:00 pm,Northwoods Casino,98264,NLH,30,30,"0% of buy-in extracted for charity, per state law.",1.0,No Rebuy
1615,2/03/2023 11:00:00 am,Mohegan Sun,6382,NLH,200,170,30,0.85,NLH w/Dealer Add-On
1616,2/03/2023 6:00:00 pm,Lakes Region Casino,3220,NLH,150,150,"0% of buy-in extracted for charity, per state law.",1.0,Turbo
1617,2/03/2023 6:30:00 pm,Northwoods Casino,98264,NLH,30,30,"0% of buy-in extracted for charity, per state law.",1.0,No Rebuy
1618,2/04/2023 11:00:00 am,Mohegan Sun,6382,NLH,150,125,25,0.8333333333333334,NLH w/Dealer Add-On
1619,2/04/2023 11:15:00 am,MGM Springfield,1103,NLH,250,205,45,0.82,NLH
1620,2/04/2023 1:00:00 pm,Manchester Poker Room,3103,NLH,150,119,31,0.7933333333333333,$150
1621,2/04/2023 6:30:00 pm,Northwoods Casino,98264,NLH,40,40,"0% of buy-in extracted for charity, per state law.",1.0,Bounty
1622,2/05/2023 11:00:00 am,Mohegan Sun,6382,NLH,250,220,30,0.88,Black Chip Bounty NLH
1623,2/05/2023 11:10:00 am,Foxwoods Casino,6338,NLH,360,306,54,0.85,NLH
1624,2/06/2023 10:00:00 am,Mohegan Sun,6382,NLH,150,125,25,0.8333333333333334,NLH w/Dealer Add-On
1625,2/07/2023 10:10:00 am,Foxwoods Casino,6338,NLH,160,130,30,0.8125,NLH w/Re-Entries
1626,2/07/2023 11:15:00 am,MGM Springfield,1103,NLH,150,115,35,0.7666666666666667,NLH
1627,2/07/2023 1:00:00 pm,Manchester Poker Room,3103,NLH,150,119,31,0.7933333333333333,$150
1628,2/07/2023 6:00:00 pm,Mohegan Sun,6382,NLH,150,125,25,0.8333333333333334,NLH w/Dealer Add-On
1629,2/07/2023 6:15:00 pm,MGM Springfield,1103,NLH,180,150,30,0.8333333333333334,"Survivor ($1,500 payouts)"
1630,2/08/2023 4:10:00 pm,Foxwoods Casino,6338,NLH,260,218,42,0.8384615384615385,NLH w/Re-Entries
1631,2/08/2023 5:00:00 pm,Lakes Region Casino,3220,NLH,90,90,"0% of buy-in extracted for charity, per state law.",1.0,No Rebuy
1632,2/08/2023 6:30:00 pm,Northwoods Casino,98264,NLH,40,40,"0% of buy-in extracted for charity, per state law.",1.0,Bounty
1633,2/09/2023 6:00:00 pm,Mohegan Sun,6382,NLH,150,125,25,0.8333333333333334,NLH w/Dealer Add-On
1634,2/09/2023 6:30:00 pm,Northwoods Casino,98264,NLH,30,30,"0% of buy-in extracted for charity, per state law.",1.0,No Rebuy
1635,2/10/2023 11:00:00 am,Mohegan Sun,6382,NLH,200,170,30,0.85,NLH w/Dealer Add-On
1636,2/10/2023 6:00:00 pm,Lakes Region Casino,3220,NLH,150,150,"0% of buy-in extracted for charity, per state law.",1.0,Turbo
1637,2/10/2023 6:30:00 pm,Northwoods Casino,98264,NLH,30,30,"0% of buy-in extracted for charity, per state law.",1.0,No Rebuy
1638,2/11/2023 11:00:00 am,Mohegan Sun,6382,NLH,150,125,25,0.8333333333333334,NLH w/Dealer Add-On
1639,2/11/2023 11:15:00 am,MGM Springfield,1103,NLH,250,205,45,0.82,NLH
1640,2/11/2023 6:30:00 pm,Northwoods Casino,98264,NLH,40,40,"0% of buy-in extracted for charity, per state law.",1.0,Bounty
1641,2/12/2023 11:00:00 am,Mohegan Sun,6382,NLH,250,220,30,0.88,Black Chip Bounty NLH
1642,2/12/2023 11:10:00 am,Foxwoods Casino,6338,NLH,360,306,54,0.85,NLH
1643,2/13/2023 10:00:00 am,Mohegan Sun,6382,NLH,150,125,25,0.8333333333333334,NLH w/Dealer Add-On
1644,2/14/2023 10:10:00 am,Foxwoods Casino,6338,NLH,160,130,30,0.8125,NLH w/Re-Entries
1645,2/14/2023 11:15:00 am,MGM Springfield,1103,NLH,150,115,35,0.7666666666666667,NLH
1646,2/14/2023 1:00:00 pm,Manchester Poker Room,3103,NLH,240,191,49,0.7958333333333333,SATURDAY $250
1647,2/14/2023 6:00:00 pm,Mohegan Sun,6382,NLH,150,125,25,0.8333333333333334,NLH w/Dealer Add-On
1648,2/14/2023 6:15:00 pm,MGM Springfield,1103,NLH,180,150,30,0.8333333333333334,"Survivor ($1,500 payouts)"
1649,2/15/2023 4:10:00 pm,Foxwoods Casino,6338,NLH,260,218,42,0.8384615384615385,NLH w/Re-Entries
1650,2/15/2023 5:00:00 pm,Lakes Region Casino,3220,NLH,90,90,"0% of buy-in extracted for charity, per state law.",1.0,No Rebuy
1651,2/15/2023 6:30:00 pm,Northwoods Casino,98264,NLH,40,40,"0% of buy-in extracted for charity, per state law.",1.0,Bounty
1652,2/16/2023 6:00:00 pm,Mohegan Sun,6382,NLH,150,125,25,0.8333333333333334,NLH w/Dealer Add-On
1653,2/16/2023 6:30:00 pm,Northwoods Casino,98264,NLH,30,30,"0% of buy-in extracted for charity, per state law.",1.0,No Rebuy
1654,2/17/2023 11:00:00 am,Mohegan Sun,6382,NLH,200,170,30,0.85,NLH w/Dealer Add-On
1655,2/17/2023 6:00:00 pm,Lakes Region Casino,3220,NLH,150,150,"0% of buy-in extracted for charity, per state law.",1.0,Turbo
1656,2/17/2023 6:30:00 pm,Northwoods Casino,98264,NLH,30,30,"0% of buy-in extracted for charity, per state law.",1.0,No Rebuy
1657,2/18/2023 11:00:00 am,Mohegan Sun,6382,NLH,150,125,25,0.8333333333333334,NLH w/Dealer Add-On
1658,2/18/2023 11:15:00 am,MGM Springfield,1103,NLH,250,205,45,0.82,NLH
1659,2/18/2023 11:43:00 am,Manchester Poker Room,3103,NLH,150,119,31,0.7933333333333333,_New Tournament_
1660,2/18/2023 6:30:00 pm,Northwoods Casino,98264,NLH,40,40,"0% of buy-in extracted for charity, per state law.",1.0,Bounty
1661,2/19/2023 11:00:00 am,Mohegan Sun,6382,NLH,250,220,30,0.88,Black Chip Bounty NLH
1662,2/19/2023 11:10:00 am,Foxwoods Casino,6338,NLH,360,306,54,0.85,NLH
1663,2/20/2023 10:00:00 am,Mohegan Sun,6382,NLH,150,125,25,0.8333333333333334,NLH w/Dealer Add-On
1664,2/21/2023 10:10:00 am,Foxwoods Casino,6338,NLH,160,130,30,0.8125,NLH w/Re-Entries
1665,2/21/2023 11:15:00 am,MGM Springfield,1103,NLH,150,115,35,0.7666666666666667,NLH
1666,2/21/2023 1:00:00 pm,Manchester Poker Room,3103,NLH,150,119,31,0.7933333333333333,$150
1667,2/21/2023 6:00:00 pm,Mohegan Sun,6382,NLH,150,125,25,0.8333333333333334,NLH w/Dealer Add-On
1668,2/21/2023 6:15:00 pm,MGM Springfield,1103,NLH,180,150,30,0.8333333333333334,"Survivor ($1,500 payouts)"
1669,2/22/2023 4:10:00 pm,Foxwoods Casino,6338,NLH,260,218,42,0.8384615384615385,NLH w/Re-Entries
1670,2/22/2023 5:00:00 pm,Lakes Region Casino,3220,NLH,90,90,"0% of buy-in extracted for charity, per state law.",1.0,No Rebuy
1671,2/22/2023 6:30:00 pm,Northwoods Casino,98264,NLH,40,40,"0% of buy-in extracted for charity, per state law.",1.0,Bounty
1672,2/23/2023 6:00:00 pm,Mohegan Sun,6382,NLH,150,125,25,0.8333333333333334,NLH w/Dealer Add-On
1673,2/23/2023 6:30:00 pm,Northwoods Casino,98264,NLH,30,30,"0% of buy-in extracted for charity, per state law.",1.0,No Rebuy
1674,2/24/2023 11:00:00 am,Mohegan Sun,6382,NLH,200,170,30,0.85,NLH w/Dealer Add-On
1675,2/24/2023 1:00:00 pm,Manchester Poker Room,3103,NLH,150,119,31,0.7933333333333333,$150
1676,2/24/2023 6:00:00 pm,Lakes Region Casino,3220,NLH,150,150,"0% of buy-in extracted for charity, per state law.",1.0,Turbo
1677,2/24/2023 6:30:00 pm,Northwoods Casino,98264,NLH,30,30,"0% of buy-in extracted for charity, per state law.",1.0,No Rebuy
1678,2/25/2023 11:00:00 am,Mohegan Sun,6382,NLH,150,125,25,0.8333333333333334,NLH w/Dealer Add-On
1679,2/25/2023 11:15:00 am,MGM Springfield,1103,NLH,250,205,45,0.82,NLH
1680,2/25/2023 6:30:00 pm,Northwoods Casino,98264,NLH,40,40,"0% of buy-in extracted for charity, per state law.",1.0,Bounty
1681,2/26/2023 11:00:00 am,Mohegan Sun,6382,NLH,250,220,30,0.88,Black Chip Bounty NLH
1682,2/27/2023 10:00:00 am,Mohegan Sun,6382,NLH,150,125,25,0.8333333333333334,NLH w/Dealer Add-On
1683,2/28/2023 10:10:00 am,Foxwoods Casino,6338,NLH,160,130,30,0.8125,NLH w/Re-Entries
1684,2/28/2023 11:15:00 am,MGM Springfield,1103,NLH,150,115,35,0.7666666666666667,NLH
1685,2/28/2023 1:00:00 pm,Manchester Poker Room,3103,NLH,240,191,49,0.7958333333333333,SATURDAY $250
1686,2/28/2023 6:00:00 pm,Mohegan Sun,6382,NLH,150,125,25,0.8333333333333334,NLH w/Dealer Add-On
1687,2/28/2023 6:15:00 pm,MGM Springfield,1103,NLH,180,150,30,0.8333333333333334,"Survivor ($1,500 payouts)"
1688,3/01/2023 4:10:00 pm,Foxwoods Casino,6338,NLH,260,218,42,0.8384615384615385,NLH w/Re-Entries
1689,3/01/2023 5:00:00 pm,Lakes Region Casino,3220,NLH,90,90,"0% of buy-in extracted for charity, per state law.",1.0,No Rebuy
1690,3/01/2023 6:30:00 pm,Northwoods Casino,98264,NLH,40,40,"0% of buy-in extracted for charity, per state law.",1.0,Bounty
1691,3/02/2023 6:00:00 pm,Mohegan Sun,6382,NLH,150,125,25,0.8333333333333334,NLH w/Dealer Add-On
1692,3/02/2023 6:30:00 pm,Northwoods Casino,98264,NLH,30,30,"0% of buy-in extracted for charity, per state law.",1.0,No Rebuy
1693,3/03/2023 11:00:00 am,Mohegan Sun,6382,NLH,200,170,30,0.85,NLH w/Dealer Add-On
1694,3/03/2023 1:00:00 pm,Manchester Poker Room,3103,NLH,240,191,49,0.7958333333333333,SATURDAY $250
1695,3/03/2023 6:00:00 pm,Lakes Region Casino,3220,NLH,150,150,"0% of buy-in extracted for charity, per state law.",1.0,Turbo
1696,3/03/2023 6:30:00 pm,Northwoods Casino,98264,NLH,30,30,"0% of buy-in extracted for charity, per state law.",1.0,No Rebuy
1697,3/04/2023 11:15:00 am,MGM Springfield,1103,NLH,250,205,45,0.82,NLH
1698,3/05/2023 11:00:00 am,Mohegan Sun,6382,NLH,250,220,30,0.88,Black Chip Bounty NLH
1699,3/05/2023 11:10:00 am,Foxwoods Casino,6338,NLH,360,306,54,0.85,NLH
1700,3/06/2023 10:00:00 am,Mohegan Sun,6382,NLH,150,125,25,0.8333333333333334,NLH w/Dealer Add-On
1701,3/07/2023 10:10:00 am,Foxwoods Casino,6338,NLH,160,130,30,0.8125,NLH w/Re-Entries
1702,3/07/2023 11:15:00 am,MGM Springfield,1103,NLH,150,115,35,0.7666666666666667,NLH
1703,3/07/2023 6:00:00 pm,Mohegan Sun,6382,NLH,150,125,25,0.8333333333333334,NLH w/Dealer Add-On
1704,3/07/2023 6:15:00 pm,MGM Springfield,1103,NLH,180,150,30,0.8333333333333334,"Survivor ($1,500 payouts)"
1705,3/08/2023 4:10:00 pm,Foxwoods Casino,6338,NLH,260,218,42,0.8384615384615385,NLH w/Re-Entries
1706,3/08/2023 5:00:00 pm,Lakes Region Casino,3220,NLH,90,90,"0% of buy-in extracted for charity, per state law.",1.0,No Rebuy
1707,3/08/2023 6:30:00 pm,Northwoods Casino,98264,NLH,40,40,"0% of buy-in extracted for charity, per state law.",1.0,Bounty
1708,3/09/2023 6:00:00 pm,Mohegan Sun,6382,NLH,150,125,25,0.8333333333333334,NLH w/Dealer Add-On
1709,3/09/2023 6:30:00 pm,Northwoods Casino,98264,NLH,30,30,"0% of buy-in extracted for charity, per state law.",1.0,No Rebuy
1710,3/10/2023 11:00:00 am,Mohegan Sun,6382,NLH,200,170,30,0.85,NLH w/Dealer Add-On
1711,3/10/2023 6:00:00 pm,Lakes Region Casino,3220,NLH,150,150,"0% of buy-in extracted for charity, per state law.",1.0,Turbo
1712,3/10/2023 6:30:00 pm,Northwoods Casino,98264,NLH,30,30,"0% of buy-in extracted for charity, per state law.",1.0,No Rebuy
1713,3/11/2023 11:00:00 am,Mohegan Sun,6382,NLH,150,125,25,0.8333333333333334,NLH w/Dealer Add-On
1714,3/11/2023 11:15:00 am,MGM Springfield,1103,NLH,250,205,45,0.82,NLH
1715,3/11/2023 6:30:00 pm,Northwoods Casino,98264,NLH,40,40,"0% of buy-in extracted for charity, per state law.",1.0,Bounty
1716,3/12/2023 11:00:00 am,Mohegan Sun,6382,NLH,250,220,30,0.88,Black Chip Bounty NLH
1717,3/12/2023 11:10:00 am,Foxwoods Casino,6338,NLH,360,306,54,0.85,NLH
1718,3/13/2023 10:00:00 am,Mohegan Sun,6382,NLH,150,125,25,0.8333333333333334,NLH w/Dealer Add-On
1719,3/14/2023 10:10:00 am,Foxwoods Casino,6338,NLH,160,130,30,0.8125,NLH w/Re-Entries
1720,3/14/2023 11:15:00 am,MGM Springfield,1103,NLH,150,115,35,0.7666666666666667,NLH
1721,3/14/2023 6:00:00 pm,Mohegan Sun,6382,NLH,150,125,25,0.8333333333333334,NLH w/Dealer Add-On
1722,3/14/2023 6:15:00 pm,MGM Springfield,1103,NLH,180,150,30,0.8333333333333334,"Survivor ($1,500 payouts)"
1723,3/15/2023 4:10:00 pm,Foxwoods Casino,6338,NLH,260,218,42,0.8384615384615385,NLH w/Re-Entries
1724,3/15/2023 5:00:00 pm,Lakes Region Casino,3220,NLH,90,90,"0% of buy-in extracted for charity, per state law.",1.0,No Rebuy
1725,1/14/2023 11:15:00 am,Live! Casino Philadelphia,19148,NLH,360,304,56,0.8444444444444444,$150K Guaranteed Multi-Flight - Jan. '23 - Series Event - $150K Multi-Flight
1726,1/14/2023 11:15:00 am,Rivers Casino Philadelphia,19125,NLH,560,485,75,0.8660714285714286,Mystery Rush - Jan. '23 - Series Event - Mystery Rush Bounty
1727,1/15/2023 12:00:00 pm,Mohegan Sun Pocono,18702,NLH,100,80,20,0.8,Turbo
1728,1/15/2023 3:15:00 pm,Live! Casino Philadelphia,19148,NLH,200,163,37,0.815,$5K Quad Stacks Double Green Chip Bounty
1729,1/16/2023 11:15:00 am,Live! Casino Philadelphia,19148,NLH,120,93,27,0.775,$4K Fat Stacks Green Chip Bounty
1730,1/16/2023 6:15:00 pm,Live! Casino Philadelphia,19148,NLH,100,79,21,0.79,$3K Bankroll Builder
1731,1/16/2023 7:00:00 pm,Mohegan Sun Pocono,18702,NLH,100,80,20,0.8,Turbo
1732,1/17/2023 11:15:00 am,Live! Casino Philadelphia,19148,NLH,160,130,30,0.8125,$3K Double Green Chip Bounty
1733,1/17/2023 6:15:00 pm,Rivers Casino Philadelphia,19125,NLH,130,100,30,0.7692307692307693,$6K NLH
1734,1/17/2023 6:15:00 pm,Live! Casino Philadelphia,19148,NLH,120,93,27,0.775,$4K Fat Stacks Green Chip Bounty
1735,1/18/2023 10:15:00 am,Rivers Casino Philadelphia,19125,NLH,50,38,12,0.76,Young At Heart (50+) Tournament
1736,1/18/2023 11:15:00 am,Live! Casino Philadelphia,19148,NLH,140,110,30,0.7857142857142857,$3K Quad Stacks
1737,1/18/2023 6:15:00 pm,Rivers Casino Philadelphia,19125,NLH,130,100,30,0.7692307692307693,$5K Deep Stack Turbo
1738,1/18/2023 6:15:00 pm,Live! Casino Philadelphia,19148,NLH,120,93,27,0.775,$4K Fat Stacks Green Chip Bounty
1739,1/18/2023 7:00:00 pm,Mohegan Sun Pocono,18702,NLH,100,80,20,0.8,Turbo
1740,1/19/2023 11:15:00 am,Live! Casino Philadelphia,19148,NLH,140,110,30,0.7857142857142857,$3K Quad Stacks Green Chip Bounty
1741,1/19/2023 6:15:00 pm,Live! Casino Philadelphia,19148,NLH,160,130,30,0.8125,$5K Double Green Chip Bounty
1742,1/20/2023 11:15:00 am,Live! Casino Philadelphia,19148,NLH,250,214,36,0.856,$10K Stacks-A-Delphia Double Green Chip Bounty
1743,1/20/2023 12:00:00 pm,Mohegan Sun Pocono,18702,NLH,100,80,20,0.8,Turbo
1744,1/20/2023 7:00:00 pm,Mohegan Sun Pocono,18702,NLH,125,105,20,0.84,Green Chip Bounty
1745,1/21/2023 10:15:00 am,Rivers Casino Philadelphia,19125,NLH,65,50,15,0.7692307692307693,Beginners' Tournament
1746,1/21/2023 11:15:00 am,Live! Casino Philadelphia,19148,NLH,300,249,51,0.83,$15K 30/30
1747,1/21/2023 1:15:00 pm,Rivers Casino Philadelphia,19125,NLH,160,125,35,0.78125,$5K Deep Stack NLH
1748,1/22/2023 11:15:00 am,Rivers Casino Philadelphia,19125,NLH,230,190,40,0.8260869565217391,$10K Deep Stack
1749,1/22/2023 11:15:00 am,Live! Casino Philadelphia,19148,NLH,200,163,37,0.815,Quad Stacks Double Green Chip Bounty
1750,1/22/2023 12:00:00 pm,Mohegan Sun Pocono,18702,NLH,100,80,20,0.8,Turbo
1751,1/22/2023 6:15:00 pm,Live! Casino Philadelphia,19148,NLH,130,101,29,0.7769230769230769,Triple Stacks Turbo
1752,1/23/2023 11:15:00 am,Live! Casino Philadelphia,19148,NLH,120,93,27,0.775,$4K Fat Stacks Green Chip Bounty
1753,1/23/2023 1:15:00 pm,Rivers Casino Philadelphia,19125,NLH,100,75,25,0.75,$2K NLH
1754,1/23/2023 3:15:00 pm,Live! Casino Philadelphia,19148,NLH,80,62,18,0.775,Live! 500 MegaStacks Turbo Satellite
1755,1/23/2023 6:15:00 pm,Live! Casino Philadelphia,19148,NLH,100,79,21,0.79,$3K Bankroll Builder
1756,1/23/2023 7:00:00 pm,Mohegan Sun Pocono,18702,NLH,100,80,20,0.8,Turbo
1757,1/23/2023 7:15:00 pm,Rivers Casino Philadelphia,19125,NLH,130,100,30,0.7692307692307693,$4K Double Green Chip Bounty
1758,1/24/2023 11:15:00 am,Live! Casino Philadelphia,19148,NLH,160,130,30,0.8125,$3K Double Green Chip Bounty
1759,1/24/2023 3:15:00 pm,Live! Casino Philadelphia,19148,NLH,80,62,18,0.775,Live! 500 MegaStacks Turbo Satellite
1760,1/24/2023 6:15:00 pm,Rivers Casino Philadelphia,19125,NLH,130,100,30,0.7692307692307693,$6K NLH
1761,1/24/2023 6:15:00 pm,Live! Casino Philadelphia,19148,NLH,120,93,27,0.775,$4K Fat Stacks Green Chip Bounty
1762,1/25/2023 10:15:00 am,Rivers Casino Philadelphia,19125,NLH,50,38,12,0.76,Young At Heart (50+) Tournament
1763,1/25/2023 11:15:00 am,Live! Casino Philadelphia,19148,NLH,140,110,30,0.7857142857142857,$3K Quad Stacks
1764,1/25/2023 3:15:00 pm,Live! Casino Philadelphia,19148,NLH,80,62,18,0.775,Live! 500 MegaStacks Turbo Satellite
1765,1/25/2023 6:15:00 pm,Rivers Casino Philadelphia,19125,NLH,130,100,30,0.7692307692307693,$5K Deep Stack Turbo
1766,1/25/2023 6:15:00 pm,Live! Casino Philadelphia,19148,NLH,120,93,27,0.775,$4K Fat Stacks Green Chip Bounty
1767,1/25/2023 7:00:00 pm,Mohegan Sun Pocono,18702,NLH,100,80,20,0.8,Turbo
1768,1/26/2023 11:15:00 am,Live! Casino Philadelphia,19148,NLH,500,424,76,0.848,$150K Live! Megastacks - Jan. '23 - Series Event - $150K Live! MegaStacks
1769,1/26/2023 3:15:00 pm,Live! Casino Philadelphia,19148,NLH,80,62,18,0.775,Live! 500 MegaStacks Turbo Satellite
1770,1/26/2023 6:15:00 pm,Live! Casino Philadelphia,19148,NLH,500,424,76,0.848,$150K Live! Megastacks - Jan. '23 - Series Event - $150K Live! MegaStacks
1771,1/27/2023 11:15:00 am,Live! Casino Philadelphia,19148,NLH,500,424,76,0.848,$150K Live! Megastacks - Jan. '23 - Series Event - $150K Live! MegaStacks
1772,1/27/2023 12:00:00 pm,Mohegan Sun Pocono,18702,NLH,100,80,20,0.8,Turbo
1773,1/27/2023 3:15:00 pm,Live! Casino Philadelphia,19148,NLH,80,62,18,0.775,Live! 500 MegaStacks Turbo Satellite
1774,1/27/2023 6:15:00 pm,Live! Casino Philadelphia,19148,NLH,500,424,76,0.848,$150K Live! Megastacks - Jan. '23 - Series Event - $150K Live! MegaStacks
1775,1/27/2023 7:00:00 pm,Mohegan Sun Pocono,18702,NLH,125,105,20,0.84,Green Chip Bounty
1776,1/28/2023 9:15:00 am,Live! Casino Philadelphia,19148,NLH,80,62,18,0.775,Live! 500 MegaStacks Turbo Satellite
1777,1/28/2023 10:15:00 am,Rivers Casino Philadelphia,19125,NLH,65,50,15,0.7692307692307693,Beginners' Tournament
1778,1/28/2023 11:15:00 am,Live! Casino Philadelphia,19148,NLH,500,424,76,0.848,$150K Live! Megastacks - Jan. '23 - Series Event - $150K Live! MegaStacks
1779,1/28/2023 1:15:00 pm,Rivers Casino Philadelphia,19125,NLH,160,125,35,0.78125,$5K Deep Stack NLH
1780,1/29/2023 11:15:00 am,Rivers Casino Philadelphia,19125,NLH,230,190,40,0.8260869565217391,$10K Deep Stack
1781,1/29/2023 12:00:00 pm,Mohegan Sun Pocono,18702,NLH,100,80,20,0.8,Turbo
1782,1/29/2023 3:15:00 pm,Live! Casino Philadelphia,19148,NLH,200,163,37,0.815,Quad Stacks Double Green Chip Bounty
1783,1/30/2023 11:15:00 am,Live! Casino Philadelphia,19148,NLH,120,93,27,0.775,$4K Fat Stacks Green Chip Bounty
1784,1/30/2023 1:15:00 pm,Rivers Casino Philadelphia,19125,NLH,100,75,25,0.75,$2K NLH
1785,1/30/2023 6:15:00 pm,Live! Casino Philadelphia,19148,NLH,100,79,21,0.79,$3K Bankroll Builder
1786,1/30/2023 7:00:00 pm,Mohegan Sun Pocono,18702,NLH,100,80,20,0.8,Turbo
1787,1/30/2023 7:15:00 pm,Rivers Casino Philadelphia,19125,NLH,130,100,30,0.7692307692307693,$4K Double Green Chip Bounty
1788,1/31/2023 11:15:00 am,Live! Casino Philadelphia,19148,NLH,160,130,30,0.8125,$3K Double Green Chip Bounty
1789,1/31/2023 6:15:00 pm,Rivers Casino Philadelphia,19125,NLH,130,100,30,0.7692307692307693,$6K NLH
1790,1/31/2023 6:15:00 pm,Live! Casino Philadelphia,19148,NLH,120,93,27,0.775,$4K Fat Stacks Green Chip Bounty
1791,2/01/2023 10:15:00 am,Rivers Casino Philadelphia,19125,NLH,50,38,12,0.76,Young At Heart (50+) Tournament
1792,2/01/2023 11:15:00 am,Live! Casino Philadelphia,19148,NLH,140,110,30,0.7857142857142857,$3K Quad Stacks
1793,2/01/2023 6:15:00 pm,Rivers Casino Philadelphia,19125,NLH,130,100,30,0.7692307692307693,$5K Deep Stack Turbo
1794,2/01/2023 6:15:00 pm,Live! Casino Philadelphia,19148,NLH,120,93,27,0.775,$4K Fat Stacks Green Chip Bounty
1795,2/01/2023 7:00:00 pm,Mohegan Sun Pocono,18702,NLH,100,80,20,0.8,Turbo
1796,2/02/2023 11:15:00 am,Live! Casino Philadelphia,19148,NLH,140,110,30,0.7857142857142857,$3K Quad Stacks Green Chip Bounty
1797,2/02/2023 6:15:00 pm,Live! Casino Philadelphia,19148,NLH,160,130,30,0.8125,$5K Double Green Chip Bounty
1798,2/03/2023 11:15:00 am,Live! Casino Philadelphia,19148,NLH,250,214,36,0.856,$8K Stacks-A-Delphia Double Green Chip Bounty
1799,2/03/2023 12:00:00 pm,Mohegan Sun Pocono,18702,NLH,100,80,20,0.8,Turbo
1800,2/03/2023 7:00:00 pm,Mohegan Sun Pocono,18702,NLH,125,105,20,0.84,Green Chip Bounty
1801,2/04/2023 10:15:00 am,Rivers Casino Philadelphia,19125,NLH,65,50,15,0.7692307692307693,Beginners' Tournament
1802,2/04/2023 1:15:00 pm,Rivers Casino Philadelphia,19125,NLH,160,125,35,0.78125,$5K Deep Stack NLH
1803,2/05/2023 11:15:00 am,Rivers Casino Philadelphia,19125,NLH,230,190,40,0.8260869565217391,$10K Deep Stack
1804,2/05/2023 11:15:00 am,Live! Casino Philadelphia,19148,NLH,200,163,37,0.815,Quad Stacks Double Green Chip Bounty
1805,2/05/2023 12:00:00 pm,Mohegan Sun Pocono,18702,NLH,100,80,20,0.8,Turbo
1806,2/05/2023 6:15:00 pm,Live! Casino Philadelphia,19148,NLH,130,101,29,0.7769230769230769,Triple Stacks Turbo
1807,2/06/2023 11:15:00 am,Live! Casino Philadelphia,19148,NLH,120,93,27,0.775,$4K Fat Stacks Green Chip Bounty
1808,2/06/2023 1:15:00 pm,Rivers Casino Philadelphia,19125,NLH,100,75,25,0.75,$2K NLH
1809,2/06/2023 6:15:00 pm,Live! Casino Philadelphia,19148,NLH,100,79,21,0.79,$3K Bankroll Builder
1810,2/06/2023 7:00:00 pm,Mohegan Sun Pocono,18702,NLH,100,80,20,0.8,Turbo
1811,2/06/2023 7:15:00 pm,Rivers Casino Philadelphia,19125,NLH,130,100,30,0.7692307692307693,$4K Double Green Chip Bounty
1812,2/07/2023 11:15:00 am,Live! Casino Philadelphia,19148,NLH,160,130,30,0.8125,$3K Double Green Chip Bounty
1813,2/07/2023 6:15:00 pm,Rivers Casino Philadelphia,19125,NLH,130,100,30,0.7692307692307693,$6K NLH
1814,2/07/2023 6:15:00 pm,Live! Casino Philadelphia,19148,NLH,120,93,27,0.775,$4K Fat Stacks Green Chip Bounty
1815,2/08/2023 10:15:00 am,Rivers Casino Philadelphia,19125,NLH,50,38,12,0.76,Young At Heart (50+) Tournament
1816,2/08/2023 11:15:00 am,Live! Casino Philadelphia,19148,NLH,140,110,30,0.7857142857142857,$3K Quad Stacks
1817,2/08/2023 6:15:00 pm,Rivers Casino Philadelphia,19125,NLH,130,100,30,0.7692307692307693,$5K Deep Stack Turbo
1818,2/08/2023 6:15:00 pm,Live! Casino Philadelphia,19148,NLH,120,93,27,0.775,$4K Fat Stacks Green Chip Bounty
1819,2/08/2023 7:00:00 pm,Mohegan Sun Pocono,18702,NLH,100,80,20,0.8,Turbo
1820,2/09/2023 11:15:00 am,Live! Casino Philadelphia,19148,NLH,140,110,30,0.7857142857142857,$3K Quad Stacks Green Chip Bounty
1821,2/09/2023 6:15:00 pm,Live! Casino Philadelphia,19148,NLH,160,130,30,0.8125,$5K Double Green Chip Bounty
1822,2/10/2023 11:15:00 am,Live! Casino Philadelphia,19148,NLH,250,214,36,0.856,$8K Stacks-A-Delphia Double Green Chip Bounty
1823,2/10/2023 12:00:00 pm,Mohegan Sun Pocono,18702,NLH,100,80,20,0.8,Turbo
1824,2/10/2023 7:00:00 pm,Mohegan Sun Pocono,18702,NLH,125,105,20,0.84,Green Chip Bounty
1825,2/11/2023 10:15:00 am,Rivers Casino Philadelphia,19125,NLH,65,50,15,0.7692307692307693,Beginners' Tournament
1826,2/11/2023 1:15:00 pm,Rivers Casino Philadelphia,19125,NLH,160,125,35,0.78125,$5K Deep Stack NLH
1827,2/12/2023 11:15:00 am,Rivers Casino Philadelphia,19125,NLH,230,190,40,0.8260869565217391,$10K Deep Stack
1828,2/12/2023 11:15:00 am,Live! Casino Philadelphia,19148,NLH,200,163,37,0.815,Quad Stacks Double Green Chip Bounty
1829,2/12/2023 12:00:00 pm,Mohegan Sun Pocono,18702,NLH,100,80,20,0.8,Turbo
1830,2/12/2023 6:15:00 pm,Live! Casino Philadelphia,19148,NLH,130,101,29,0.7769230769230769,Triple Stacks Turbo
1831,2/13/2023 11:15:00 am,Live! Casino Philadelphia,19148,NLH,120,93,27,0.775,$4K Fat Stacks Green Chip Bounty
1832,2/13/2023 1:15:00 pm,Rivers Casino Philadelphia,19125,NLH,100,75,25,0.75,$2K NLH
1833,2/13/2023 6:15:00 pm,Live! Casino Philadelphia,19148,NLH,100,79,21,0.79,$3K Bankroll Builder
1834,2/13/2023 7:00:00 pm,Mohegan Sun Pocono,18702,NLH,100,80,20,0.8,Turbo
1835,2/13/2023 7:15:00 pm,Rivers Casino Philadelphia,19125,NLH,130,100,30,0.7692307692307693,$4K Double Green Chip Bounty
1836,2/14/2023 11:15:00 am,Live! Casino Philadelphia,19148,NLH,160,130,30,0.8125,$3K Double Green Chip Bounty
1837,2/14/2023 6:15:00 pm,Rivers Casino Philadelphia,19125,NLH,130,100,30,0.7692307692307693,$6K NLH
1838,2/14/2023 6:15:00 pm,Live! Casino Philadelphia,19148,NLH,120,93,27,0.775,$4K Fat Stacks Green Chip Bounty
1839,2/15/2023 10:15:00 am,Rivers Casino Philadelphia,19125,NLH,50,38,12,0.76,Young At Heart (50+) Tournament
1840,2/15/2023 11:15:00 am,Live! Casino Philadelphia,19148,NLH,140,110,30,0.7857142857142857,$3K Quad Stacks
1841,2/15/2023 6:15:00 pm,Rivers Casino Philadelphia,19125,NLH,130,100,30,0.7692307692307693,$5K Deep Stack Turbo
1842,2/15/2023 6:15:00 pm,Live! Casino Philadelphia,19148,NLH,120,93,27,0.775,$4K Fat Stacks Green Chip Bounty
1843,2/15/2023 7:00:00 pm,Mohegan Sun Pocono,18702,NLH,100,80,20,0.8,Turbo
1844,2/16/2023 11:15:00 am,Live! Casino Philadelphia,19148,NLH,140,110,30,0.7857142857142857,$3K Quad Stacks Green Chip Bounty
1845,2/16/2023 6:15:00 pm,Live! Casino Philadelphia,19148,NLH,160,130,30,0.8125,$5K Double Green Chip Bounty
1846,2/17/2023 11:15:00 am,Live! Casino Philadelphia,19148,NLH,250,214,36,0.856,$8K Stacks-A-Delphia Double Green Chip Bounty
1847,2/17/2023 12:00:00 pm,Mohegan Sun Pocono,18702,NLH,100,80,20,0.8,Turbo
1848,2/17/2023 7:00:00 pm,Mohegan Sun Pocono,18702,NLH,125,105,20,0.84,Green Chip Bounty
1849,2/18/2023 10:15:00 am,Rivers Casino Philadelphia,19125,NLH,65,50,15,0.7692307692307693,Beginners' Tournament
1850,2/18/2023 1:15:00 pm,Rivers Casino Philadelphia,19125,NLH,160,125,35,0.78125,$5K Deep Stack NLH
1851,2/19/2023 11:15:00 am,Rivers Casino Philadelphia,19125,NLH,230,190,40,0.8260869565217391,$10K Deep Stack
1852,2/19/2023 11:15:00 am,Live! Casino Philadelphia,19148,NLH,200,163,37,0.815,Quad Stacks Double Green Chip Bounty
1853,2/19/2023 12:00:00 pm,Mohegan Sun Pocono,18702,NLH,100,80,20,0.8,Turbo
1854,2/19/2023 6:15:00 pm,Live! Casino Philadelphia,19148,NLH,130,101,29,0.7769230769230769,Triple Stacks Turbo
1855,2/20/2023 11:15:00 am,Live! Casino Philadelphia,19148,NLH,120,93,27,0.775,$4K Fat Stacks Green Chip Bounty
1856,2/20/2023 1:15:00 pm,Rivers Casino Philadelphia,19125,NLH,100,75,25,0.75,$2K NLH
1857,2/20/2023 6:15:00 pm,Live! Casino Philadelphia,19148,NLH,100,79,21,0.79,$3K Bankroll Builder
1858,2/20/2023 7:00:00 pm,Mohegan Sun Pocono,18702,NLH,100,80,20,0.8,Turbo
1859,2/20/2023 7:15:00 pm,Rivers Casino Philadelphia,19125,NLH,130,100,30,0.7692307692307693,$4K Double Green Chip Bounty
1860,2/21/2023 11:15:00 am,Live! Casino Philadelphia,19148,NLH,160,130,30,0.8125,$3K Double Green Chip Bounty
1861,2/21/2023 6:15:00 pm,Rivers Casino Philadelphia,19125,NLH,130,100,30,0.7692307692307693,$6K NLH
1862,2/21/2023 6:15:00 pm,Live! Casino Philadelphia,19148,NLH,120,93,27,0.775,$4K Fat Stacks Green Chip Bounty
1863,2/22/2023 10:15:00 am,Rivers Casino Philadelphia,19125,NLH,50,38,12,0.76,Young At Heart (50+) Tournament
1864,2/22/2023 11:15:00 am,Live! Casino Philadelphia,19148,NLH,140,110,30,0.7857142857142857,$3K Quad Stacks
1865,2/22/2023 6:15:00 pm,Rivers Casino Philadelphia,19125,NLH,130,100,30,0.7692307692307693,$5K Deep Stack Turbo
1866,2/22/2023 6:15:00 pm,Live! Casino Philadelphia,19148,NLH,120,93,27,0.775,$4K Fat Stacks Green Chip Bounty
1867,2/22/2023 7:00:00 pm,Mohegan Sun Pocono,18702,NLH,100,80,20,0.8,Turbo
1868,2/23/2023 11:15:00 am,Live! Casino Philadelphia,19148,NLH,140,110,30,0.7857142857142857,$3K Quad Stacks Green Chip Bounty
1869,2/23/2023 6:15:00 pm,Live! Casino Philadelphia,19148,NLH,160,130,30,0.8125,$5K Double Green Chip Bounty
1870,2/24/2023 11:15:00 am,Live! Casino Philadelphia,19148,NLH,250,214,36,0.856,$8K Stacks-A-Delphia Double Green Chip Bounty
1871,2/24/2023 12:00:00 pm,Mohegan Sun Pocono,18702,NLH,100,80,20,0.8,Turbo
1872,2/24/2023 7:00:00 pm,Mohegan Sun Pocono,18702,NLH,125,105,20,0.84,Green Chip Bounty
1873,2/25/2023 10:15:00 am,Rivers Casino Philadelphia,19125,NLH,65,50,15,0.7692307692307693,Beginners' Tournament
1874,2/25/2023 1:15:00 pm,Rivers Casino Philadelphia,19125,NLH,160,125,35,0.78125,$5K Deep Stack NLH
1875,2/26/2023 11:15:00 am,Rivers Casino Philadelphia,19125,NLH,230,190,40,0.8260869565217391,$10K Deep Stack
1876,2/26/2023 11:15:00 am,Live! Casino Philadelphia,19148,NLH,200,163,37,0.815,Quad Stacks Double Green Chip Bounty
1877,2/26/2023 12:00:00 pm,Mohegan Sun Pocono,18702,NLH,100,80,20,0.8,Turbo
1878,2/26/2023 6:15:00 pm,Live! Casino Philadelphia,19148,NLH,130,101,29,0.7769230769230769,Triple Stacks Turbo
1879,2/27/2023 11:15:00 am,Live! Casino Philadelphia,19148,NLH,120,93,27,0.775,$4K Fat Stacks Green Chip Bounty
1880,2/27/2023 1:15:00 pm,Rivers Casino Philadelphia,19125,NLH,100,75,25,0.75,$2K NLH
1881,2/27/2023 6:15:00 pm,Live! Casino Philadelphia,19148,NLH,100,79,21,0.79,$3K Bankroll Builder
1882,2/27/2023 7:00:00 pm,Mohegan Sun Pocono,18702,NLH,100,80,20,0.8,Turbo
1883,2/27/2023 7:15:00 pm,Rivers Casino Philadelphia,19125,NLH,130,100,30,0.7692307692307693,$4K Double Green Chip Bounty
1884,2/28/2023 11:15:00 am,Live! Casino Philadelphia,19148,NLH,160,130,30,0.8125,$3K Double Green Chip Bounty
1885,3/01/2023 11:15:00 am,Live! Casino Philadelphia,19148,NLH,140,110,30,0.7857142857142857,$3K Quad Stacks
1886,3/01/2023 7:00:00 pm,Mohegan Sun Pocono,18702,NLH,100,80,20,0.8,Turbo
1887,3/02/2023 11:15:00 am,Live! Casino Philadelphia,19148,NLH,140,110,30,0.7857142857142857,$3K Quad Stacks Green Chip Bounty
1888,3/02/2023 6:15:00 pm,Live! Casino Philadelphia,19148,NLH,160,130,30,0.8125,$5K Double Green Chip Bounty
1889,3/03/2023 11:15:00 am,Live! Casino Philadelphia,19148,NLH,250,214,36,0.856,$8K Stacks-A-Delphia Double Green Chip Bounty
1890,3/03/2023 12:00:00 pm,Mohegan Sun Pocono,18702,NLH,100,80,20,0.8,Turbo
1891,3/03/2023 7:00:00 pm,Mohegan Sun Pocono,18702,NLH,125,105,20,0.84,Green Chip Bounty
1892,3/04/2023 10:15:00 am,Rivers Casino Philadelphia,19125,NLH,65,50,15,0.7692307692307693,Beginners' Tournament
1893,3/04/2023 1:15:00 pm,Rivers Casino Philadelphia,19125,NLH,160,125,35,0.78125,$5K Deep Stack NLH
1894,3/05/2023 11:15:00 am,Rivers Casino Philadelphia,19125,NLH,230,190,40,0.8260869565217391,$10K Deep Stack
1895,3/05/2023 11:15:00 am,Live! Casino Philadelphia,19148,NLH,200,163,37,0.815,Quad Stacks Double Green Chip Bounty
1896,3/05/2023 12:00:00 pm,Mohegan Sun Pocono,18702,NLH,100,80,20,0.8,Turbo
1897,3/05/2023 6:15:00 pm,Live! Casino Philadelphia,19148,NLH,130,101,29,0.7769230769230769,Triple Stacks Turbo
1898,3/06/2023 11:15:00 am,Live! Casino Philadelphia,19148,NLH,120,93,27,0.775,$4K Fat Stacks Green Chip Bounty
1899,3/06/2023 1:15:00 pm,Rivers Casino Philadelphia,19125,NLH,100,75,25,0.75,$2K NLH
1900,3/06/2023 6:15:00 pm,Live! Casino Philadelphia,19148,NLH,100,79,21,0.79,$3K Bankroll Builder
1901,3/06/2023 7:00:00 pm,Mohegan Sun Pocono,18702,NLH,100,80,20,0.8,Turbo
1902,3/06/2023 7:15:00 pm,Rivers Casino Philadelphia,19125,NLH,130,100,30,0.7692307692307693,$4K Double Green Chip Bounty
1903,3/07/2023 11:15:00 am,Live! Casino Philadelphia,19148,NLH,160,130,30,0.8125,$3K Double Green Chip Bounty
1904,3/07/2023 6:15:00 pm,Live! Casino Philadelphia,19148,NLH,120,93,27,0.775,$4K Fat Stacks Green Chip Bounty
1905,3/07/2023 6:15:00 pm,Rivers Casino Philadelphia,19125,NLH,130,100,30,0.7692307692307693,$6K NLH
1906,3/08/2023 10:15:00 am,Rivers Casino Philadelphia,19125,NLH,50,38,12,0.76,Young At Heart (50+) Tournament
1907,3/08/2023 11:15:00 am,Live! Casino Philadelphia,19148,NLH,140,110,30,0.7857142857142857,$3K Quad Stacks
1908,3/08/2023 6:15:00 pm,Live! Casino Philadelphia,19148,NLH,120,93,27,0.775,$4K Fat Stacks Green Chip Bounty
1909,3/08/2023 6:15:00 pm,Rivers Casino Philadelphia,19125,NLH,130,100,30,0.7692307692307693,$5K Deep Stack Turbo
1910,3/08/2023 7:00:00 pm,Mohegan Sun Pocono,18702,NLH,100,80,20,0.8,Turbo
1911,3/09/2023 11:15:00 am,Live! Casino Philadelphia,19148,NLH,140,110,30,0.7857142857142857,$3K Quad Stacks Green Chip Bounty
1912,3/09/2023 6:15:00 pm,Live! Casino Philadelphia,19148,NLH,160,130,30,0.8125,$5K Double Green Chip Bounty
1913,3/10/2023 11:15:00 am,Live! Casino Philadelphia,19148,NLH,250,214,36,0.856,$8K Stacks-A-Delphia Double Green Chip Bounty
1914,3/10/2023 12:00:00 pm,Mohegan Sun Pocono,18702,NLH,100,80,20,0.8,Turbo
1915,3/10/2023 7:00:00 pm,Mohegan Sun Pocono,18702,NLH,125,105,20,0.84,Green Chip Bounty
1916,3/11/2023 10:15:00 am,Rivers Casino Philadelphia,19125,NLH,65,50,15,0.7692307692307693,Beginners' Tournament
1917,3/11/2023 1:15:00 pm,Rivers Casino Philadelphia,19125,NLH,160,125,35,0.78125,$5K Deep Stack NLH
1918,3/12/2023 11:15:00 am,Rivers Casino Philadelphia,19125,NLH,230,190,40,0.8260869565217391,$10K Deep Stack
1919,3/12/2023 11:15:00 am,Live! Casino Philadelphia,19148,NLH,200,163,37,0.815,Quad Stacks Double Green Chip Bounty
1920,3/12/2023 12:00:00 pm,Mohegan Sun Pocono,18702,NLH,100,80,20,0.8,Turbo
1921,3/12/2023 6:15:00 pm,Live! Casino Philadelphia,19148,NLH,130,101,29,0.7769230769230769,Triple Stacks Turbo
1922,3/13/2023 11:15:00 am,Live! Casino Philadelphia,19148,NLH,120,93,27,0.775,$4K Fat Stacks Green Chip Bounty
1923,3/13/2023 1:15:00 pm,Rivers Casino Philadelphia,19125,NLH,100,75,25,0.75,$2K NLH
1924,3/13/2023 6:15:00 pm,Live! Casino Philadelphia,19148,NLH,100,79,21,0.79,$3K Bankroll Builder
1925,3/13/2023 7:00:00 pm,Mohegan Sun Pocono,18702,NLH,100,80,20,0.8,Turbo
1926,3/13/2023 7:15:00 pm,Rivers Casino Philadelphia,19125,NLH,130,100,30,0.7692307692307693,$4K Double Green Chip Bounty
1927,3/14/2023 11:15:00 am,Live! Casino Philadelphia,19148,NLH,160,130,30,0.8125,$3K Double Green Chip Bounty
1928,3/14/2023 6:15:00 pm,Live! Casino Philadelphia,19148,NLH,120,93,27,0.775,$4K Fat Stacks Green Chip Bounty
1929,3/14/2023 6:15:00 pm,Rivers Casino Philadelphia,19125,NLH,130,100,30,0.7692307692307693,$6K NLH
1930,3/15/2023 10:15:00 am,Rivers Casino Philadelphia,19125,NLH,50,38,12,0.76,Young At Heart (50+) Tournament
1931,3/15/2023 11:15:00 am,Live! Casino Philadelphia,19148,NLH,140,110,30,0.7857142857142857,$3K Quad Stacks
1932,1/14/2023 9:15:00 am,Maryland Live! Casino at Arundel Mills,21076,NLH,300,255,45,0.85,2023 Mid-Atlantic Poker Open - Satellite - MAPO Main Event Satellite
1933,1/14/2023 11:15:00 am,MGM National Harbor,20745,NLH,400,336,64,0.84,PWPO Main Event Satellite (2 seats guaranteed)
1934,1/14/2023 5:15:00 pm,Maryland Live! Casino at Arundel Mills,21076,NLH,80,64,16,0.8,2023 Mid-Atlantic Poker Open - Satellite - Turbo Satellite to MAPO Event 15
1935,1/14/2023 6:15:00 pm,Maryland Live! Casino at Arundel Mills,21076,NLH,2200,1958,242,0.89,2023 Mid-Atlantic Poker Open - Event #14 - $500K Main Event
1936,1/14/2023 7:15:00 pm,Horseshoe Baltimore,21230,NLH,150,110,40,0.7333333333333333,"$1,500 NLH"
1937,1/15/2023 10:15:00 am,Maryland Live! Casino at Arundel Mills,21076,NLH,80,64,16,0.8,2023 Mid-Atlantic Poker Open - Satellite - Turbo Satellite to MAPO Event 15
1938,1/15/2023 2:00:00 pm,Hollywood Casino Perryville,21903,NLH,150,121,29,0.8066666666666666,$3K NLH Freezeout
1939,1/15/2023 2:15:00 pm,Maryland Live! Casino at Arundel Mills,21076,NLH,550,472,78,0.8581818181818182,2023 Mid-Atlantic Poker Open - Event #15 - $25K Progressive Bounty
1940,1/16/2023 11:15:00 am,Maryland Live! Casino at Arundel Mills,21076,NLH,400,337,63,0.8425,2023 Mid-Atlantic Poker Open - Event #16 - $40K Black Chip Bounty
1941,1/16/2023 11:15:00 am,Horseshoe Baltimore,21230,NLH,260,210,50,0.8076923076923077,2023 WSOP Main Event Satellite
1942,1/17/2023 11:15:00 am,Maryland Live! Casino at Arundel Mills,21076,NLH,130,98,32,0.7538461538461538,Triple Stacks
1943,1/17/2023 11:15:00 am,MGM National Harbor,20745,NLH,165,133,32,0.806060606060606,$5K Double Green Chip Bounty
1944,1/17/2023 7:00:00 pm,Hollywood Casino Perryville,21903,NLH,100,71,29,0.71,Deep Stack NLH w/Add-on
1945,1/17/2023 7:15:00 pm,MGM National Harbor,20745,NLH,300,246,54,0.82,$10K Black Chip Bounty
1946,1/17/2023 7:15:00 pm,Maryland Live! Casino at Arundel Mills,21076,NLH,200,163,37,0.815,$10K Quad Stacks Double Green Chip Bounty
1947,1/18/2023 11:15:00 am,Maryland Live! Casino at Arundel Mills,21076,NLH,200,167,33,0.835,"Turbo Bounty Survivor ($1,200 payouts)"
1948,1/18/2023 11:15:00 am,MGM National Harbor,20745,NLH,150,113,37,0.7533333333333333,$5K NLH
1949,1/18/2023 3:15:00 pm,Maryland Live! Casino at Arundel Mills,21076,NLH,50,39,11,0.78,30/30 Turbo Satellite
1950,1/18/2023 7:15:00 pm,Maryland Live! Casino at Arundel Mills,21076,NLH,130,98,32,0.7538461538461538,$10K Triple Stacks
1951,1/18/2023 7:15:00 pm,MGM National Harbor,20745,NLH,200,163,37,0.815,$6K Deep Stack
1952,1/19/2023 11:15:00 am,Maryland Live! Casino at Arundel Mills,21076,NLH,140,108,32,0.7714285714285715,Quad Stacks
1953,1/19/2023 11:15:00 am,MGM National Harbor,20745,NLH,200,163,37,0.815,$5K Triple Green Chip Bounty
1954,1/19/2023 3:15:00 pm,Maryland Live! Casino at Arundel Mills,21076,NLH,50,39,11,0.78,30/30 Turbo Satellite
1955,1/19/2023 7:00:00 pm,Hollywood Casino Perryville,21903,NLH,100,73,27,0.73,"$1,500 Green Chip Bounty"
1956,1/19/2023 7:15:00 pm,Maryland Live! Casino at Arundel Mills,21076,NLH,160,128,32,0.8,Double Green Chip Bounty
1957,1/19/2023 7:15:00 pm,MGM National Harbor,20745,NLH,400,336,64,0.84,$15K NLH
1958,1/20/2023 10:00:00 am,Hollywood Casino Perryville,21903,NLH,100,71,29,0.71,Deep Stack NLH w/Add-on
1959,1/20/2023 11:15:00 am,Maryland Live! Casino at Arundel Mills,21076,NLH,220,174,46,0.7909090909090909,Deep Stacks
1960,1/20/2023 11:15:00 am,MGM National Harbor,20745,NLH,300,251,49,0.8366666666666667,$8K Deep Stack Turbo
1961,1/20/2023 3:15:00 pm,Maryland Live! Casino at Arundel Mills,21076,NLH,50,39,11,0.78,30/30 Turbo Satellite
1962,1/20/2023 7:15:00 pm,Maryland Live! Casino at Arundel Mills,21076,NLH,320,266,54,0.83125,Triple Green Chip Bounty
1963,1/20/2023 7:15:00 pm,Horseshoe Baltimore,21230,NLH,150,110,40,0.7333333333333333,"$1,500 NLH"
1964,1/21/2023 9:15:00 am,Maryland Live! Casino at Arundel Mills,21076,NLH,50,39,11,0.78,30/30 Turbo Satellite
1965,1/21/2023 11:15:00 am,Maryland Live! Casino at Arundel Mills,21076,NLH,300,247,53,0.8233333333333334,$30K 30/30
1966,1/21/2023 11:15:00 am,MGM National Harbor,20745,NLH,500,420,80,0.84,PWPO Main Event Satellite (10 seats guaranteed)
1967,1/21/2023 7:15:00 pm,Horseshoe Baltimore,21230,NLH,150,110,40,0.7333333333333333,"$1,500 NLH"
1968,1/22/2023 11:15:00 am,Maryland Live! Casino at Arundel Mills,21076,NLH,250,206,44,0.824,$15K Mystery Bounty
1969,1/22/2023 11:15:00 am,MGM National Harbor,20745,NLH,500,420,80,0.84,PWPO Main Event Satellite (10 seats guaranteed)
1970,1/22/2023 2:00:00 pm,Hollywood Casino Perryville,21903,NLH,150,121,29,0.8066666666666666,$3K NLH Freezeout
1971,1/22/2023 6:15:00 pm,Maryland Live! Casino at Arundel Mills,21076,NLH,130,99,31,0.7615384615384615,Triple Stacks Turbo
1972,1/23/2023 11:15:00 am,Maryland Live! Casino at Arundel Mills,21076,NLH,120,91,29,0.7583333333333333,Fat Stacks Green Chip Bounty
1973,1/23/2023 11:15:00 am,MGM National Harbor,20745,NLH,150,113,37,0.7533333333333333,$5K NLH
1974,1/23/2023 7:15:00 pm,Maryland Live! Casino at Arundel Mills,21076,NLH,140,103,37,0.7357142857142858,Ladies Only (Leaderboard to Vegas) Powered by PLON
1975,1/23/2023 7:15:00 pm,MGM National Harbor,20745,NLH,300,246,54,0.82,$10K NLH
1976,1/24/2023 11:15:00 am,Maryland Live! Casino at Arundel Mills,21076,NLH,130,98,32,0.7538461538461538,Triple Stacks
1977,1/24/2023 11:15:00 am,MGM National Harbor,20745,NLH,165,133,32,0.806060606060606,$5K Double Green Chip Bounty
1978,1/24/2023 7:00:00 pm,Hollywood Casino Perryville,21903,NLH,100,71,29,0.71,Deep Stack NLH w/Add-on
1979,1/24/2023 7:15:00 pm,MGM National Harbor,20745,NLH,300,246,54,0.82,$10K Black Chip Bounty
1980,1/24/2023 7:15:00 pm,Maryland Live! Casino at Arundel Mills,21076,NLH,200,163,37,0.815,$10K Quad Stacks Double Green Chip Bounty
1981,1/25/2023 11:15:00 am,Maryland Live! Casino at Arundel Mills,21076,NLH,200,167,33,0.835,"Turbo Bounty Survivor ($1,200 payouts)"
1982,1/25/2023 3:15:00 pm,Maryland Live! Casino at Arundel Mills,21076,NLH,50,39,11,0.78,Black Chip Bounty Turbo Satellite
1983,1/25/2023 5:00:00 pm,MGM National Harbor,20745,NLH,400,330,70,0.825,2023 Potomac Winter Poker Open - Event #1 - $500K Mystery Bounty
1984,1/25/2023 7:15:00 pm,Maryland Live! Casino at Arundel Mills,21076,NLH,130,98,32,0.7538461538461538,$10K Triple Stacks
1985,1/26/2023 11:15:00 am,Maryland Live! Casino at Arundel Mills,21076,NLH,140,108,32,0.7714285714285715,Quad Stacks
1986,1/26/2023 3:15:00 pm,Maryland Live! Casino at Arundel Mills,21076,NLH,50,39,11,0.78,Black Chip Bounty Turbo Satellite
1987,1/26/2023 5:00:00 pm,MGM National Harbor,20745,NLH,400,330,70,0.825,2023 Potomac Winter Poker Open - Event #1 - $500K Mystery Bounty
1988,1/26/2023 7:00:00 pm,Hollywood Casino Perryville,21903,NLH,100,73,27,0.73,"$1,500 Green Chip Bounty"
1989,1/26/2023 7:15:00 pm,Maryland Live! Casino at Arundel Mills,21076,NLH,160,128,32,0.8,Double Green Chip Bounty
1990,1/27/2023 10:00:00 am,Hollywood Casino Perryville,21903,NLH,100,71,29,0.71,Deep Stack NLH w/Add-on
1991,1/27/2023 11:00:00 am,MGM National Harbor,20745,NLH,400,330,70,0.825,2023 Potomac Winter Poker Open - Event #1 - $500K Mystery Bounty
1992,1/27/2023 11:15:00 am,Maryland Live! Casino at Arundel Mills,21076,NLH,220,174,46,0.7909090909090909,Deep Stacks
1993,1/27/2023 3:15:00 pm,Maryland Live! Casino at Arundel Mills,21076,NLH,50,39,11,0.78,Black Chip Bounty Turbo Satellite
1994,1/27/2023 5:00:00 pm,MGM National Harbor,20745,NLH,400,330,70,0.825,2023 Potomac Winter Poker Open - Event #1 - $500K Mystery Bounty
1995,1/27/2023 7:15:00 pm,Maryland Live! Casino at Arundel Mills,21076,NLH,320,266,54,0.83125,Triple Green Chip Bounty
1996,1/27/2023 7:15:00 pm,Horseshoe Baltimore,21230,NLH,150,110,40,0.7333333333333333,"$1,500 NLH"
1997,1/28/2023 9:15:00 am,Maryland Live! Casino at Arundel Mills,21076,NLH,50,39,11,0.78,Holiday Black Chip Bounty Turbo Satellite
1998,1/28/2023 9:15:00 am,Maryland Live! Casino at Arundel Mills,21076,NLH,50,39,11,0.78,Black Chip Bounty Turbo Satellite
1999,1/28/2023 11:00:00 am,MGM National Harbor,20745,NLH,400,330,70,0.825,2023 Potomac Winter Poker Open - Event #1 - $500K Mystery Bounty
2000,1/28/2023 5:00:00 pm,MGM National Harbor,20745,NLH,400,330,70,0.825,2023 Potomac Winter Poker Open - Event #1 - $500K Mystery Bounty
2001,1/28/2023 7:15:00 pm,Horseshoe Baltimore,21230,NLH,150,110,40,0.7333333333333333,"$1,500 NLH"
2002,1/29/2023 9:00:00 am,MGM National Harbor,20745,NLH,300,250,50,0.8333333333333334,2023 Potomac Winter Poker Open - Event #2 - Seniors (50+) NLH
2003,1/29/2023 11:15:00 am,Maryland Live! Casino at Arundel Mills,21076,NLH,100,69,31,0.69,$10K Bankroll Builder
2004,1/29/2023 1:00:00 pm,MGM National Harbor,20745,NLH,400,330,70,0.825,2023 Potomac Winter Poker Open - Event #3 - $50K NLH
2005,1/29/2023 2:00:00 pm,Hollywood Casino Perryville,21903,NLH,150,121,29,0.8066666666666666,$3K NLH Freezeout
2006,1/29/2023 4:00:00 pm,MGM National Harbor,20745,PLO,500,425,75,0.85,2023 Potomac Winter Poker Open - Event #4 - 5-Card Pot-Limit Omaha w/Rebuys
2007,1/29/2023 6:15:00 pm,Maryland Live! Casino at Arundel Mills,21076,NLH,130,99,31,0.7615384615384615,Triple Stacks Turbo
2008,1/30/2023 11:15:00 am,Maryland Live! Casino at Arundel Mills,21076,NLH,120,91,29,0.7583333333333333,Fat Stacks Green Chip Bounty
2009,1/30/2023 12:00:00 pm,MGM National Harbor,20745,NLH,300,250,50,0.8333333333333334,2023 Potomac Winter Poker Open - Event #5 - Cake's Classic Bounty
2010,1/30/2023 7:15:00 pm,Maryland Live! Casino at Arundel Mills,21076,NLH,200,164,36,0.82,NLH
2011,1/31/2023 11:00:00 am,MGM National Harbor,20745,NLH,400,330,70,0.825,2023 Potomac Winter Poker Open - Event #6 - Monster Triple Stack
2012,1/31/2023 11:15:00 am,Maryland Live! Casino at Arundel Mills,21076,NLH,130,98,32,0.7538461538461538,Triple Stacks
2013,1/31/2023 7:00:00 pm,Hollywood Casino Perryville,21903,NLH,100,71,29,0.71,Deep Stack NLH w/Add-on
2014,1/31/2023 7:15:00 pm,Maryland Live! Casino at Arundel Mills,21076,NLH,200,163,37,0.815,$10K Quad Stacks Double Green Chip Bounty
2015,2/01/2023 11:00:00 am,MGM National Harbor,20745,NLH,400,330,70,0.825,2023 Potomac Winter Poker Open - Event #7 - $50K NLH
2016,2/01/2023 4:00:00 pm,MGM National Harbor,20745,NLH,400,330,70,0.825,2023 Potomac Winter Poker Open - Event #8 - Super Turbo Black Chip Bounty
2017,2/02/2023 11:00:00 am,MGM National Harbor,20745,NLH,1200,1100,100,0.9166666666666666,2023 Potomac Winter Poker Open - Event #9 - $50K Freezeout
2018,2/02/2023 11:15:00 am,Maryland Live! Casino at Arundel Mills,21076,NLH,140,108,32,0.7714285714285715,Quad Stacks
2019,2/02/2023 4:00:00 pm,MGM National Harbor,20745,MLHA,400,330,70,0.825,2023 Potomac Winter Poker Open - Event #10 - NLH-PLO Mix
2020,2/02/2023 7:00:00 pm,Hollywood Casino Perryville,21903,NLH,100,73,27,0.73,"$1,500 Green Chip Bounty"
2021,2/02/2023 7:15:00 pm,Maryland Live! Casino at Arundel Mills,21076,NLH,160,128,32,0.8,Double Green Chip Bounty
2022,2/03/2023 10:00:00 am,Hollywood Casino Perryville,21903,NLH,100,71,29,0.71,Deep Stack NLH w/Add-on
2023,2/03/2023 11:00:00 am,MGM National Harbor,20745,NLH,2700,2400,300,0.8888888888888888,2023 Potomac Winter Poker Open - Event #11 - $500K Main Event
2024,2/03/2023 11:15:00 am,Maryland Live! Casino at Arundel Mills,21076,NLH,220,174,46,0.7909090909090909,Deep Stacks
2025,2/03/2023 7:15:00 pm,Maryland Live! Casino at Arundel Mills,21076,NLH,320,266,54,0.83125,Triple Green Chip Bounty
2026,2/03/2023 7:15:00 pm,Horseshoe Baltimore,21230,NLH,150,110,40,0.7333333333333333,"$1,500 NLH"
2027,2/04/2023 9:00:00 am,MGM National Harbor,20745,NLH,300,250,50,0.8333333333333334,2023 Potomac Winter Poker Open - Event #12 - Seniors (50+) NLH
2028,2/04/2023 11:00:00 am,MGM National Harbor,20745,NLH,2700,2400,300,0.8888888888888888,2023 Potomac Winter Poker Open - Event #11 - $500K Main Event
2029,2/04/2023 7:00:00 pm,MGM National Harbor,20745,NLH,200,165,35,0.825,2023 Potomac Winter Poker Open - Event #13 - Rookies NLH (`must have less than $25K in Hendon Mob cashes)
2030,2/04/2023 7:15:00 pm,Horseshoe Baltimore,21230,NLH,150,110,40,0.7333333333333333,"$1,500 NLH"
2031,2/05/2023 1:00:00 pm,MGM National Harbor,20745,NLH,400,330,70,0.825,2023 Potomac Winter Poker Open - Event #14 - $50K NLH
2032,2/05/2023 2:00:00 pm,Hollywood Casino Perryville,21903,NLH,150,121,29,0.8066666666666666,$3K NLH Freezeout
2033,2/05/2023 5:00:00 pm,MGM National Harbor,20745,PL5CO,1200,1100,100,0.9166666666666666,2023 Potomac Winter Poker Open - Event #15 - 5-Card Pot-Limit Omaha Championship
2034,2/05/2023 6:15:00 pm,Maryland Live! Casino at Arundel Mills,21076,NLH,130,99,31,0.7615384615384615,Triple Stacks Turbo
2035,2/06/2023 11:00:00 am,MGM National Harbor,20745,NLH,400,330,70,0.825,2023 Potomac Winter Poker Open - Event #16 - Double Stack
2036,2/06/2023 11:15:00 am,Maryland Live! Casino at Arundel Mills,21076,NLH,120,91,29,0.7583333333333333,Fat Stacks Green Chip Bounty
2037,2/07/2023 11:15:00 am,Maryland Live! Casino at Arundel Mills,21076,NLH,130,98,32,0.7538461538461538,Triple Stacks
2038,2/07/2023 11:15:00 am,MGM National Harbor,20745,NLH,165,133,32,0.806060606060606,$5K Double Green Chip Bounty
2039,2/07/2023 7:00:00 pm,Hollywood Casino Perryville,21903,NLH,100,71,29,0.71,Deep Stack NLH w/Add-on
2040,2/07/2023 7:15:00 pm,MGM National Harbor,20745,NLH,300,246,54,0.82,$10K Black Chip Bounty
2041,2/07/2023 7:15:00 pm,Maryland Live! Casino at Arundel Mills,21076,NLH,200,163,37,0.815,$10K Quad Stacks Double Green Chip Bounty
2042,2/08/2023 11:15:00 am,MGM National Harbor,20745,NLH,150,113,37,0.7533333333333333,$5K NLH
2043,2/08/2023 7:15:00 pm,MGM National Harbor,20745,NLH,200,163,37,0.815,$6K Deep Stack
2044,2/09/2023 11:15:00 am,Maryland Live! Casino at Arundel Mills,21076,NLH,140,108,32,0.7714285714285715,Quad Stacks
2045,2/09/2023 11:15:00 am,MGM National Harbor,20745,NLH,200,163,37,0.815,$5K Triple Green Chip Bounty
2046,1/14/2023 10:00:00 am,Seminole Coconut Creek,33073,NLH,130,98,32,0.7538461538461538,No-Limit Hold'em Deepstack 8-Max)
2047,1/14/2023 10:00:00 am,Seminole Hard Rock Hollywood,33314,NLH,600,520,80,0.8666666666666667,2023 Lucky Hearts Poker Open - Event #1 - No Limit Hold'em Deep Stack
2048,1/14/2023 10:00:00 am,Seminole Hard Rock Hollywood,33314,NLH,150,125,25,0.8333333333333334,2023 Lucky Hearts Poker Open - Event #53 - Multi Turbo Satellite into LHPO Any $600 & Any $400 Event +$250 Cash
2049,1/14/2023 11:00:00 am,Seminole Hard Rock Hollywood,33314,PL5CO,1100,970,130,0.8818181818181818,2023 Lucky Hearts Poker Open - Event #7 - 5-Card PLO Deep Stack (8-Handed)
2050,1/14/2023 11:15:00 am,Palm Beach Kennel Club,33409,NLH,250,205,45,0.82,No-Limit Hold'em Bounty
2051,1/14/2023 12:00:00 pm,The Casino @ Dania Beach,33004,NLH,50,24,26,0.48,No-Limit Hold'em
2052,1/14/2023 12:00:00 pm,Seminole Hard Rock Hollywood,33314,NLH,250,210,40,0.84,2023 Lucky Hearts Poker Open - Event #54 - Multi Turbo Satellite into Any $1100 Event & Any $600 Event +$400 Cash
2053,1/14/2023 3:00:00 pm,Seminole Hard Rock Hollywood,33314,NLH,550,500,50,0.9090909090909092,2023 Lucky Hearts Poker Open - Event #55 - No Limit Hold'em Survivor
2054,1/14/2023 6:00:00 pm,The Casino @ Dania Beach,33004,NLH,80,48,32,0.6,No-Limit Hold'em
2055,1/14/2023 6:00:00 pm,Seminole Coconut Creek,33073,NLH,200,162,38,0.81,No-Limit Hold'em Survivor
2056,1/14/2023 6:00:00 pm,Harrah's Pompano Beach,33069,NLH,130,100,30,0.7692307692307693,No-Limit Hold'em
2057,1/14/2023 6:00:00 pm,Seminole Hard Rock Hollywood,33314,NLH,600,520,80,0.8666666666666667,2023 Lucky Hearts Poker Open - Event #1 - No Limit Hold'em Deep Stack
2058,1/14/2023 6:15:00 pm,Palm Beach Kennel Club,33409,NLH,100,70,30,0.7,No-Limit Hold'em
2059,1/15/2023 10:00:00 am,Seminole Coconut Creek,33073,NLH,100,78,22,0.78,"No-Limit Hold'em - Turbo - 8 - Max- $25 Bounty ($5,000 guaranteed)"
2060,1/15/2023 12:00:00 pm,Seminole Hard Rock Hollywood,33314,NLH,250,210,40,0.84,2023 Lucky Hearts Poker Open - Event #56 - Multi Turbo Satellite into Any $1100 Event & Any $600 Event +$400 Cash
2061,1/15/2023 1:00:00 pm,Casino Miami Jai-Alai,33142,NLH,75,75,5% House fee on all monies collected,1.0,No-Limit Hold'em
2062,1/15/2023 1:00:00 pm,Seminole Hard Rock Hollywood,33314,NLH,400,335,65,0.8375,2023 Lucky Hearts Poker Open - Event #8 - No Limit Hold'em Deep Stack
2063,1/15/2023 1:15:00 pm,Palm Beach Kennel Club,33409,NLH,150,115,35,0.7666666666666667,No-Limit Hold'em
2064,1/15/2023 4:00:00 pm,Seminole Hard Rock Hollywood,33314,NLH,1100,970,130,0.8818181818181818,2023 Lucky Hearts Poker Open - Event #9 - No Limit Hold'em Deep Stack
2065,1/15/2023 5:00:00 pm,The Casino @ Dania Beach,33004,NLH,150,106,44,0.7066666666666667,No-Limit Hold'em
2066,1/15/2023 5:00:00 pm,Seminole Hard Rock Hollywood,33314,PLOMix,600,525,75,0.875,"2023 Lucky Hearts Poker Open - Event #10 - Mixed Pot Limit Omaha Deep Stack (PLO, PLO8, Big O)"
2067,1/15/2023 6:00:00 pm,Seminole Coconut Creek,33073,NLH,100,78,22,0.78,"No-Limit Hold'em - Eight-Max - Turbo - $25 Bounty ($2,000 Guaranteed)"
2068,1/15/2023 6:00:00 pm,Seminole Hard Rock Hollywood,33314,NLH,200,160,40,0.8,2023 Lucky Hearts Poker Open - Event #11 - NLH Double Green Chip Bounty Quad Stack
2069,1/15/2023 8:00:00 pm,Seminole Hard Rock Hollywood,33314,NLH,400,360,40,0.9,2023 Lucky Hearts Poker Open - Event #57 - Mega Turbo Satellite into LHPO Championship Event
2070,1/16/2023 11:00:00 am,Seminole Coconut Creek,33073,NLH,150,123,27,0.82,No-Limit Hold'em Deep Stack Survivor
2071,1/16/2023 11:00:00 am,Seminole Hard Rock Hollywood,33314,NLH,200,160,40,0.8,2023 Lucky Hearts Poker Open - Event #12 - No Limit Hold'em Big Stack
2072,1/16/2023 11:15:00 am,Palm Beach Kennel Club,33409,NLH,125,95,30,0.76,No-Limit Hold'em - $25 Bounty
2073,1/16/2023 12:00:00 pm,Seminole Hard Rock Hollywood,33314,NLH,250,210,40,0.84,2023 Lucky Hearts Poker Open - Event #58 - Multi Turbo Satellite into Any $1100 Event & Any $600 Event +$400 Cash
2074,1/16/2023 12:00:00 pm,Seminole Hard Rock Hollywood,33314,PLBigO/8,600,525,75,0.875,2023 Lucky Hearts Poker Open - Event #13 - Big O Deep Stack
2075,1/16/2023 3:00:00 pm,Seminole Hard Rock Hollywood,33314,NLH,200,160,40,0.8,2023 Lucky Hearts Poker Open - Event #12 - No Limit Hold'em Big Stack
2076,1/16/2023 4:00:00 pm,Seminole Hard Rock Hollywood,33314,PLO,400,335,65,0.8375,2023 Lucky Hearts Poker Open - Event #14 - PLO Deep Stack Black Chip Bounty
2077,1/16/2023 5:00:00 pm,Harrah's Pompano Beach,33069,NLH,250,203,47,0.812,No Limit Hold'em
2078,1/16/2023 5:00:00 pm,Seminole Hard Rock Hollywood,33314,NLH,250,210,40,0.84,2023 Lucky Hearts Poker Open - Event #59 - Mega Turbo Satellite into LHPO Event #19
2079,1/16/2023 6:00:00 pm,Seminole Coconut Creek,33073,NLH,200,162,38,0.81,No-Limit Hold'em Double Green Chip Bounty 8-Max
2080,1/16/2023 6:00:00 pm,The Casino @ Dania Beach,33004,NLH,60,36,24,0.6,No-Limit Hold'em
2081,1/16/2023 6:15:00 pm,Palm Beach Kennel Club,33409,NLH,100,70,30,0.7,No-Limit Hold'em Deep Stack
2082,1/16/2023 7:00:00 pm,Seminole Hard Rock Hollywood,33314,NLH,400,360,40,0.9,2023 Lucky Hearts Poker Open - Event #60 - Mega Turbo Satellite into LHPO Championship Event
2083,1/16/2023 7:00:00 pm,Seminole Hard Rock Hollywood,33314,NLH,200,160,40,0.8,2023 Lucky Hearts Poker Open - Event #12 - No Limit Hold'em Big Stack
2084,1/16/2023 8:00:00 pm,Seminole Hard Rock Hollywood,33314,NLH,600,530,70,0.8833333333333333,2023 Lucky Hearts Poker Open - Event #15 - Deep Stack Turbo NLH
2085,1/17/2023 11:00:00 am,Seminole Coconut Creek,33073,FLO8,130,98,32,0.7538461538461538,Omaha 8 or Better
2086,1/17/2023 11:00:00 am,Seminole Hard Rock Hollywood,33314,NLH,400,335,65,0.8375,2023 Lucky Hearts Poker Open - Event #16 - Seniors No Limit Hold'em (50+)
2087,1/17/2023 11:00:00 am,Seminole Hard Rock Hollywood,33314,NLH,200,160,40,0.8,2023 Lucky Hearts Poker Open - Event #12 - No Limit Hold'em Big Stack
2088,1/17/2023 11:15:00 am,Palm Beach Kennel Club,33409,NLH,130,100,30,0.7692307692307693,No-Limit Hold'em - Deep Stack
2089,1/17/2023 12:00:00 pm,Seminole Hard Rock Hollywood,33314,NLH,600,525,75,0.875,2023 Lucky Hearts Poker Open - Event #17 - No Limit Hold'em Deep Stack (6-Max)
2090,1/17/2023 1:00:00 pm,Seminole Hard Rock Hollywood,33314,NLH,250,210,40,0.84,2023 Lucky Hearts Poker Open - Event #61 - Mega Turbo Satellite into LHPO Event #19
2091,1/17/2023 3:00:00 pm,Seminole Hard Rock Hollywood,33314,NLH,200,160,40,0.8,2023 Lucky Hearts Poker Open - Event #12 - No Limit Hold'em Big Stack
2092,1/17/2023 4:00:00 pm,Seminole Hard Rock Hollywood,33314,PLO8,1100,970,130,0.8818181818181818,2023 Lucky Hearts Poker Open - Event #18 - PLO 8/B Deep Stack (6-Max)
2093,1/17/2023 5:00:00 pm,The Casino @ Dania Beach,33004,NLH,130,90,40,0.6923076923076923,No-Limit Hold'em
2094,1/17/2023 6:00:00 pm,Harrah's Pompano Beach,33069,NLH,80,55,25,0.6875,No-Limit Hold'em
2095,1/17/2023 6:00:00 pm,Seminole Coconut Creek,33073,PLO,150,118,32,0.7866666666666666,Pot Limit Omaha
2096,1/17/2023 6:00:00 pm,Seminole Hard Rock Hollywood,33314,NLH,400,360,40,0.9,2023 Lucky Hearts Poker Open - Event #62 - Mega Turbo Satellite into LHPO Championship Event
2097,1/17/2023 7:00:00 pm,Seminole Hard Rock Hollywood,33314,NLH,200,160,40,0.8,2023 Lucky Hearts Poker Open - Event #12 - No Limit Hold'em Big Stack
2098,1/17/2023 8:00:00 pm,Seminole Hard Rock Hollywood,33314,NLH,250,210,40,0.84,2023 Lucky Hearts Poker Open - Event #63 - Mega Turbo Satellite into LHPO Event #19
2099,1/18/2023 11:00:00 am,Seminole Coconut Creek,33073,NLH,130,98,32,0.7538461538461538,"No-Limit Hold'em ""Re-Do"" Turbo"
2100,1/18/2023 11:00:00 am,Seminole Hard Rock Hollywood,33314,NLH,2200,2000,200,0.9090909090909092,2023 Lucky Hearts Poker Open - Event #19 - No Limit Hold'em Deep Stack
2101,1/18/2023 11:00:00 am,Seminole Hard Rock Hollywood,33314,NLH,400,360,40,0.9,2023 Lucky Hearts Poker Open - Event #64 - Mega Satellite into LHPO Championship Event
2102,1/18/2023 11:15:00 am,Palm Beach Kennel Club,33409,NLH,100,70,30,0.7,No-Limit Hold'em Deep Stack
2103,1/18/2023 1:00:00 pm,The Casino @ Dania Beach,33004,NLH,50,24,26,0.48,No-Limit Hold'em
2104,1/18/2023 2:00:00 pm,Seminole Hard Rock Hollywood,33314,PLO,10000,9500,500,0.95,2023 Lucky Hearts Poker Open - Event #20 - Pot Limit Omaha High Roller
2105,1/18/2023 3:00:00 pm,Seminole Hard Rock Hollywood,33314,NLH,400,360,40,0.9,2023 Lucky Hearts Poker Open - Event #65 - Mega Satellite into LHPO Championship Event
2106,1/18/2023 4:00:00 pm,Seminole Hard Rock Hollywood,33314,NLH,2650,2550,100,0.9622641509433962,2023 Lucky Hearts Poker Open - Event #66 - Mega Satellite into LHPO High Roller Event #25
2107,1/18/2023 5:00:00 pm,Seminole Hard Rock Hollywood,33314,PLO,600,520,80,0.8666666666666667,2023 Lucky Hearts Poker Open - Event #21 - Pot Limit Omaha Deep Stack
2108,1/18/2023 6:00:00 pm,Seminole Coconut Creek,33073,NLH,130,98,32,0.7538461538461538,No-Limit Hold'em Deepstack
2109,1/18/2023 6:00:00 pm,Seminole Hard Rock Hollywood,33314,NLH,200,160,40,0.8,2023 Lucky Hearts Poker Open - Event #22 - NLH Double Green Chip Bounty Quad Stack
2110,1/18/2023 6:15:00 pm,Palm Beach Kennel Club,33409,NLH,125,95,30,0.76,No-Limit Hold'em Bounty
2111,1/14/2023 11:00:00 am,Club 52 Melbourne Greyhound Park,32935,NLH,1100,1000,100,0.9090909090909092,52 Poker Crew Open
2112,1/14/2023 12:15:00 pm,Oxford Downs Poker Room,34491,NLH,100,78,22,0.78,No-Limit Hold'em
2113,1/15/2023 12:15:00 pm,Oxford Downs Poker Room,34491,NLH,230,195,35,0.8478260869565217,No-Limit Hold'em - First and Third Sunday of the Month
2114,1/15/2023 3:00:00 pm,Ocala Gainesville Poker,32681,NLH,65,50,15,0.7692307692307693,"No-Limit Hold'em ($1,000 Guaranteed to 1st)"
2115,1/16/2023 6:15:00 pm,Oxford Downs Poker Room,34491,NLH,40,32,8,0.8,No-Limit Hold'em - Turbo
2116,1/16/2023 6:30:00 pm,Club 52 Melbourne Greyhound Park,32935,NLH,60,40,20,0.6666666666666666,No Limit Hold'em $60 buy-in 6000 in chips
2117,1/17/2023 7:10:00 pm,Orange City Racing & Card Club,32763,NLH,155,125,30,0.8064516129032258,No-Limit Hold'em - Great American Poker Tournament
2118,1/18/2023 12:15:00 pm,Oxford Downs Poker Room,34491,NLH,40,30,10,0.75,"No-Limit Hold'em - $10 Bounty ($2,000 Guaranteed)"
2119,1/18/2023 6:15:00 pm,Oxford Downs Poker Room,34491,NLH,125,103,22,0.824,"No-Limit Hold'em - $25 Bounty ($2,000 Guaranteed)"
2120,1/18/2023 6:30:00 pm,Club 52 Melbourne Greyhound Park,32935,NLH,70,50,20,0.7142857142857143,"Turbo $70 buy-in 12,000 in chips"
2121,1/19/2023 6:15:00 pm,Oxford Downs Poker Room,34491,NLH,55,41,14,0.7454545454545455,Deep Stack Turbo
2122,1/19/2023 7:10:00 pm,Orange City Racing & Card Club,32763,NLH,100,75,25,0.75,Double Stack Turbo - GAPT
2123,1/20/2023 6:30:00 pm,Club 52 Melbourne Greyhound Park,32935,NLH,60,40,20,0.6666666666666666,Friday Night $60
2124,1/21/2023 12:15:00 pm,Oxford Downs Poker Room,34491,NLH,100,78,22,0.78,No-Limit Hold'em
2125,1/22/2023 3:00:00 pm,Ocala Gainesville Poker,32681,NLH,65,50,15,0.7692307692307693,"No-Limit Hold'em ($1,000 Guaranteed to 1st)"
2126,1/23/2023 6:15:00 pm,Oxford Downs Poker Room,34491,NLH,40,32,8,0.8,No-Limit Hold'em - Turbo
2127,1/23/2023 6:30:00 pm,Club 52 Melbourne Greyhound Park,32935,NLH,60,40,20,0.6666666666666666,No Limit Hold'em $60 buy-in 6000 in chips
2128,1/23/2023 7:10:00 pm,Orange City Racing & Card Club,32763,NLH,130,100,30,0.7692307692307693,No-Limit Hold'em Triple Stack Turbo
2129,1/24/2023 7:10:00 pm,Orange City Racing & Card Club,32763,NLH,155,125,30,0.8064516129032258,No-Limit Hold'em - Great American Poker Tournament
2130,1/25/2023 12:15:00 pm,Oxford Downs Poker Room,34491,NLH,40,30,10,0.75,"No-Limit Hold'em - $10 Bounty ($2,000 Guaranteed)"
2131,1/25/2023 6:15:00 pm,Oxford Downs Poker Room,34491,NLH,125,103,22,0.824,"No-Limit Hold'em - $25 Bounty ($2,000 Guaranteed)"
2132,1/25/2023 6:30:00 pm,Club 52 Melbourne Greyhound Park,32935,NLH,70,50,20,0.7142857142857143,"Turbo $70 buy-in 12,000 in chips"
2133,1/26/2023 12:10:00 pm,Daytona Beach Racing and Card Club,32114,NLH,365,300,65,0.821917808219178,"The GAPT $200,000 Tournament Jan 2023 - Series Event - No-Limit Hold'em"
2134,1/26/2023 6:10:00 pm,Daytona Beach Racing and Card Club,32114,NLH,365,300,65,0.821917808219178,"The GAPT $200,000 Tournament Jan 2023 - Series Event - No-Limit Hold'em"
2135,1/26/2023 6:15:00 pm,Oxford Downs Poker Room,34491,NLH,55,41,14,0.7454545454545455,Deep Stack Turbo
2136,1/26/2023 6:30:00 pm,Club 52 Melbourne Greyhound Park,32935,NLH,150,125,25,0.8333333333333334,$150 No Limit Holdem Bounty
2137,1/26/2023 7:10:00 pm,Orange City Racing & Card Club,32763,NLH,100,75,25,0.75,Double Stack Turbo - GAPT
2138,1/27/2023 11:00:00 am,Club 52 Melbourne Greyhound Park,32935,NLH,70,50,20,0.7142857142857143,"Omaha PLO High/low $70 Buy-in 14,000 in chips"
2139,1/27/2023 12:10:00 pm,Daytona Beach Racing and Card Club,32114,NLH,365,300,65,0.821917808219178,"The GAPT $200,000 Tournament Jan 2023 - Series Event - No-Limit Hold'em"
2140,1/27/2023 6:10:00 pm,Daytona Beach Racing and Card Club,32114,NLH,365,300,65,0.821917808219178,"The GAPT $200,000 Tournament Jan 2023 - Series Event - No-Limit Hold'em"
2141,1/27/2023 6:30:00 pm,Club 52 Melbourne Greyhound Park,32935,NLH,60,40,20,0.6666666666666666,Friday Night $60
2142,1/28/2023 12:10:00 pm,Daytona Beach Racing and Card Club,32114,NLH,365,300,65,0.821917808219178,"The GAPT $200,000 Tournament Jan 2023 - Series Event - No-Limit Hold'em"
2143,1/28/2023 12:15:00 pm,Oxford Downs Poker Room,34491,NLH,100,78,22,0.78,No-Limit Hold'em
2144,1/28/2023 1:00:00 pm,Ocala Gainesville Poker,32681,NLH,135,110,25,0.8148148148148148,Last Saturday of the Month NLH
2145,1/28/2023 6:10:00 pm,Daytona Beach Racing and Card Club,32114,NLH,365,300,65,0.821917808219178,"The GAPT $200,000 Tournament Jan 2023 - Series Event - No-Limit Hold'em"
2146,1/29/2023 12:15:00 pm,Oxford Downs Poker Room,34491,NLH,55,41,14,0.7454545454545455,No-Limit Hold'em
2147,1/29/2023 3:00:00 pm,Ocala Gainesville Poker,32681,NLH,65,50,15,0.7692307692307693,"No-Limit Hold'em ($1,000 Guaranteed to 1st)"
2148,1/30/2023 6:15:00 pm,Oxford Downs Poker Room,34491,NLH,40,32,8,0.8,No-Limit Hold'em - Turbo
2149,1/30/2023 6:30:00 pm,Club 52 Melbourne Greyhound Park,32935,NLH,60,40,20,0.6666666666666666,No Limit Hold'em $60 buy-in 6000 in chips
2150,1/30/2023 7:10:00 pm,Orange City Racing & Card Club,32763,NLH,130,100,30,0.7692307692307693,No-Limit Hold'em Triple Stack Turbo
2151,1/31/2023 7:10:00 pm,Orange City Racing & Card Club,32763,NLH,155,125,30,0.8064516129032258,No-Limit Hold'em - Great American Poker Tournament
2152,2/01/2023 12:15:00 pm,Oxford Downs Poker Room,34491,NLH,40,30,10,0.75,"No-Limit Hold'em - $10 Bounty ($2,000 Guaranteed)"
2153,2/01/2023 6:15:00 pm,Oxford Downs Poker Room,34491,NLH,125,103,22,0.824,"No-Limit Hold'em - $25 Bounty ($2,000 Guaranteed)"
2154,2/02/2023 6:15:00 pm,Oxford Downs Poker Room,34491,NLH,55,41,14,0.7454545454545455,Deep Stack Turbo
2155,2/02/2023 8:10:00 pm,Orange City Racing & Card Club,32763,NLH,70,51,19,0.7285714285714285,"Mel's Hot Rock Tournament ($3,000 Guaranteed)"
2156,2/04/2023 11:00:00 am,Club 52 Melbourne Greyhound Park,32935,NLH,130,100,30,0.7692307692307693,"$15,000 Guaranteed NLHT"
2157,2/04/2023 12:15:00 pm,Oxford Downs Poker Room,34491,NLH,100,78,22,0.78,No-Limit Hold'em
2158,2/05/2023 12:15:00 pm,Oxford Downs Poker Room,34491,NLH,230,195,35,0.8478260869565217,No-Limit Hold'em - First and Third Sunday of the Month
2159,2/05/2023 3:00:00 pm,Ocala Gainesville Poker,32681,NLH,65,50,15,0.7692307692307693,"No-Limit Hold'em ($1,000 Guaranteed to 1st)"
2160,2/06/2023 6:15:00 pm,Oxford Downs Poker Room,34491,NLH,40,32,8,0.8,No-Limit Hold'em - Turbo
2161,2/06/2023 7:10:00 pm,Orange City Racing & Card Club,32763,NLH,130,100,30,0.7692307692307693,No-Limit Hold'em Triple Stack Turbo
2162,2/07/2023 7:10:00 pm,Orange City Racing & Card Club,32763,NLH,155,125,30,0.8064516129032258,No-Limit Hold'em - Great American Poker Tournament
2163,2/08/2023 12:15:00 pm,Oxford Downs Poker Room,34491,NLH,40,30,10,0.75,"No-Limit Hold'em - $10 Bounty ($2,000 Guaranteed)"
2164,2/08/2023 6:15:00 pm,Oxford Downs Poker Room,34491,NLH,125,103,22,0.824,"No-Limit Hold'em - $25 Bounty ($2,000 Guaranteed)"
2165,1/14/2023 9:30:00 am,Bonita Springs Poker Room,34135,NLH,0,0,0,1.1,$300-$700 Early Bird High Hand
2166,1/14/2023 11:00:00 am,Seminole Hard Rock Tampa,33610,NLH,250,205,45,0.82,No Limit Hold'em Triple 30's
2167,1/14/2023 11:00:00 am,Bonita Springs Poker Room,34135,NLH,200,165,35,0.825,$200=P$165/H$20/D10/J$5
2168,1/14/2023 12:00:00 pm,Derby Lane Poker Room,33702,NLH,125,106,19,0.848,$125 Green Chip Bounty
2169,1/14/2023 1:00:00 pm,Silks @ Tampa Bay Downs,33626,NLH,110,90,20,0.8181818181818182,$110 Super Stack $3K GTD
2170,1/14/2023 1:00:00 pm,One-Eyed Jacks,59801,NLH,140,120,20,0.8571428571428571,$140 Bounty ($20 Bounties)
2171,1/14/2023 2:00:00 pm,TGT Poker & Racebook,33604,NLH,50,33,17,0.66,$50 Mega Stack $1000 Guarantee
2172,1/14/2023 6:00:00 pm,TGT Poker & Racebook,33604,NLH,60,48,12,0.8,Single Tables with Guaranteed Payouts
2173,1/14/2023 6:00:00 pm,Bonita Springs Poker Room,34135,NLH,0,0,0,1.1,Saturday PM High hand($500 every 30 min)
2174,1/14/2023 6:30:00 pm,One-Eyed Jacks,59801,NLH,100,80,20,0.8,$100 Madness
2175,1/14/2023 6:30:00 pm,Derby Lane Poker Room,33702,NLH,80,62,18,0.775,$80 Saturday Standard $2.5K GTE
2176,1/14/2023 7:00:00 pm,TGT Poker & Racebook,33604,NLH,60,48,12,0.8,Single Tables with Guaranteed Payouts
2177,1/14/2023 7:00:00 pm,Silks @ Tampa Bay Downs,33626,NLH,80,60,20,0.75,$80 Max Stack Blitz $2K GTD
2178,1/14/2023 8:00:00 pm,TGT Poker & Racebook,33604,NLH,60,48,12,0.8,Single Tables with Guaranteed Payouts
2179,1/14/2023 9:00:00 pm,TGT Poker & Racebook,33604,NLH,60,48,12,0.8,Single Tables with Guaranteed Payouts
2180,1/14/2023 10:00:00 pm,TGT Poker & Racebook,33604,NLH,60,48,12,0.8,Single Tables with Guaranteed Payouts
2181,1/15/2023 9:30:00 am,Bonita Springs Poker Room,34135,NLH,0,0,0,1.1,$300-$700 Early Bird High Hand
2182,1/15/2023 11:00:00 am,Bonita Springs Poker Room,34135,NLH,400,345,55,0.8625,$400-$20k Guar $345P H$40/S$10/J$5
2183,1/15/2023 12:00:00 pm,Seminole Hard Rock Tampa,33610,NLH,200,160,40,0.8,Bankroll Builder No Limit Hold'em
2184,1/15/2023 1:00:00 pm,Silks @ Tampa Bay Downs,33626,NLH,55,37,18,0.6727272727272727,$55 Super Stack Blitz $1K GTD
2185,1/15/2023 1:00:00 pm,One-Eyed Jacks,59801,NLH,120,100,20,0.8333333333333334,$120 NLH
2186,1/15/2023 5:00:00 pm,One-Eyed Jacks,59801,NLH,50,50,0,1.0,$50 Rake Free Turbo
2187,1/15/2023 6:30:00 pm,Derby Lane Poker Room,33702,NLH,50,37,13,0.74,$50 Double Board Bomb Pot $1K GTE
2188,1/15/2023 7:00:00 pm,Silks @ Tampa Bay Downs,33626,NLH,65,45,20,0.6923076923076923,"$65 Super Stack $1,500 GTD"
2189,1/15/2023 7:00:00 pm,Bonita Springs Poker Room,34135,NLOther,0,0,0,1.1,$300-$700 Evening high hand
2190,1/16/2023 9:30:00 am,Bonita Springs Poker Room,34135,NLH,0,0,0,1.1,Special High Hand day
2191,1/16/2023 9:30:00 am,Bonita Springs Poker Room,34135,NLH,0,0,0,1.1,$300-$700 Early Bird High Hand
2192,1/16/2023 11:00:00 am,Seminole Hard Rock Tampa,33610,NLH,80,60,20,0.75,No-Limit Hold'em
2193,1/16/2023 11:00:00 am,Derby Lane Poker Room,33702,NLH,25,14,11,0.56,$25 Quarter Kickoff $450 GTE
2194,1/16/2023 11:00:00 am,Bonita Springs Poker Room,34135,NLH,125,95,30,0.76,$125=TURBO $95/$15/$10/$5
2195,1/16/2023 1:00:00 pm,Silks @ Tampa Bay Downs,33626,NLH,55,37,18,0.6727272727272727,$55 Super Stack Blitz $1K GTD
2196,1/16/2023 6:00:00 pm,Seminole Hard Rock Tampa,33610,NLH,180,144,36,0.8,No-Limit Hold'em Triple Stack Special
2197,1/16/2023 6:00:00 pm,Silks @ Tampa Bay Downs,33626,NLH,150,130,20,0.8666666666666667,"$150 $10,000 GTD"
2198,1/16/2023 6:30:00 pm,One-Eyed Jacks,59801,NLH,150,130,20,0.8666666666666667,***$150 Deep Stack
2199,1/16/2023 6:30:00 pm,Derby Lane Poker Room,33702,NLH,60,46,14,0.7666666666666667,$60 $6K GTE
2200,1/16/2023 7:00:00 pm,Bonita Springs Poker Room,34135,NLOther,0,0,0,1.1,$300-$700 Evening high hand
2201,1/17/2023 9:30:00 am,Bonita Springs Poker Room,34135,NLH,0,0,0,1.1,$300-$700 Early Bird High Hand
2202,1/17/2023 11:00:00 am,Seminole Hard Rock Tampa,33610,NLH,80,60,20,0.75,Satellite into $600 Deep Stack
2203,1/17/2023 11:00:00 am,Derby Lane Poker Room,33702,NLH,50,38,12,0.76,$50 Deep Stack Deal $1K GTE
2204,1/17/2023 11:00:00 am,Bonita Springs Poker Room,34135,NLH,100,75,25,0.75,$100=P$75/H$10/S$10/J$5
2205,1/17/2023 1:00:00 pm,Silks @ Tampa Bay Downs,33626,NLH,55,37,18,0.6727272727272727,$55 Super Stack Blitz $1K GTD
2206,1/17/2023 1:00:00 pm,One-Eyed Jacks,59801,NLH,80,68,12,0.85,Colossus
2207,1/17/2023 6:00:00 pm,Bonita Springs Poker Room,34135,NLH,125,95,30,0.76,$125=TURBO $95/$15/$10/$5
2208,1/17/2023 6:30:00 pm,Silks @ Tampa Bay Downs,33626,NLH,80,70,10,0.875,Bay Area Poker Club
2209,1/17/2023 6:30:00 pm,One-Eyed Jacks,59801,NLH,40,28,12,0.7,*$40 Fab 40
2210,1/17/2023 6:30:00 pm,Derby Lane Poker Room,33702,NLH,200,200,0,1.0,$200 No Rake
2211,1/17/2023 6:45:00 pm,TGT Poker & Racebook,33604,NLH,60,43,17,0.7166666666666667,$1500 Guarantee PP $60 Mega Stack
2212,1/17/2023 7:00:00 pm,Bonita Springs Poker Room,34135,NLOther,0,0,0,1.1,$300-$700 Evening high hand
2213,1/18/2023 9:30:00 am,Bonita Springs Poker Room,34135,NLH,0,0,0,1.1,"$200-$1,000 High Hand Day (Every Wednesday)"
2214,1/18/2023 11:00:00 am,Seminole Hard Rock Tampa,33610,FLO8,150,120,30,0.8,Omaha 8 or Better
2215,1/18/2023 11:00:00 am,Derby Lane Poker Room,33702,NLH,50,38,12,0.76,$50 Deep Stack Deal $1K GTE
2216,1/18/2023 1:00:00 pm,Silks @ Tampa Bay Downs,33626,NLH,55,37,18,0.6727272727272727,$55 Super Stack Blitz $1K GTD
2217,1/18/2023 1:00:00 pm,One-Eyed Jacks,59801,NLH,60,48,12,0.8,*$60 Mega Stack
2218,1/18/2023 6:00:00 pm,Seminole Hard Rock Tampa,33610,NLH,180,144,36,0.8,No-Limit Hold'em Triple Stack
2219,1/18/2023 6:30:00 pm,One-Eyed Jacks,59801,NLH,100,100,0,1.0,$100 Wacky No Rake
2220,1/18/2023 6:30:00 pm,Derby Lane Poker Room,33702,NLH,100,81,19,0.81,$100 $10K GTE
2221,1/18/2023 6:45:00 pm,TGT Poker & Racebook,33604,NLH,25,17,8,0.68,"$25 Satellite for $10,000 guarantee Elevator"
2222,1/18/2023 7:00:00 pm,Silks @ Tampa Bay Downs,33626,NLH,65,45,20,0.6923076923076923,"$65 Super Stack $1,500 GTD"
2223,1/19/2023 9:30:00 am,Bonita Springs Poker Room,34135,NLH,0,0,0,1.1,$300-$700 Early Bird High Hand
2224,1/19/2023 11:00:00 am,Seminole Hard Rock Tampa,33610,NLH,150,120,30,0.8,No-Limit Hold'em Deep Stack
2225,1/19/2023 11:00:00 am,Derby Lane Poker Room,33702,NLH,50,38,12,0.76,$50 Deep Stack Deal $1K GTE
2226,1/19/2023 11:00:00 am,Bonita Springs Poker Room,34135,NLH,100,75,25,0.75,$100=P$75/H$10/S$10/J$5
2227,1/19/2023 1:00:00 pm,Silks @ Tampa Bay Downs,33626,NLH,65,45,20,0.6923076923076923,"$65 Super Stack $1,500 GTD"
2228,1/19/2023 1:00:00 pm,One-Eyed Jacks,59801,NLH,40,28,12,0.7,$40 Fab 40
2229,1/19/2023 6:00:00 pm,Seminole Hard Rock Tampa,33610,NLH,180,144,36,0.8,No-Limit Hold'em Triple Stack
2230,1/19/2023 6:00:00 pm,TGT Poker & Racebook,33604,FLOther,100,80,20,0.8,WSOP Mixed Game League
2231,1/19/2023 6:00:00 pm,Bonita Springs Poker Room,34135,NLH,225,190,35,0.8444444444444444,$225=$190/$20/$10/$5
2232,1/19/2023 6:30:00 pm,One-Eyed Jacks,59801,NLH,150,130,20,0.8666666666666667,***$150 Deep Stack
2233,1/19/2023 6:30:00 pm,Derby Lane Poker Room,33702,NLH,30,21,9,0.7,$30 $3K GTE
2234,1/19/2023 6:45:00 pm,TGT Poker & Racebook,33604,NLH,60,43,17,0.7166666666666667,$1500 Guarantee PP $60 Mega Stack
2235,1/19/2023 7:00:00 pm,Silks @ Tampa Bay Downs,33626,NLH,30,20,10,0.6666666666666666,$30 Satellite
2236,1/19/2023 7:00:00 pm,Bonita Springs Poker Room,34135,NLOther,0,0,0,1.1,$300-$700 Evening High Hand
2237,1/20/2023 9:30:00 am,Bonita Springs Poker Room,34135,NLH,0,0,0,1.1,$300-$700 EXTENDED TO 5PM High Hand
2238,1/20/2023 11:00:00 am,Seminole Hard Rock Tampa,33610,NLH,150,120,30,0.8,No-Limit Hold'em Deep Stack
2239,1/20/2023 11:00:00 am,Derby Lane Poker Room,33702,NLH,100,92,8,0.92,$100 Player Appreciation
2240,1/20/2023 11:00:00 am,Bonita Springs Poker Room,34135,NLH,100,75,25,0.75,$100=P$75/H$10/S$10/J$5
2241,1/20/2023 1:00:00 pm,Silks @ Tampa Bay Downs,33626,NLH,55,37,18,0.6727272727272727,$55 Super Stack Blitz
2242,1/20/2023 1:00:00 pm,One-Eyed Jacks,59801,NLH,300,300,0,1.0,*$300 Rake Free!!!
2243,1/20/2023 2:00:00 pm,TGT Poker & Racebook,33604,NLH,40,27,13,0.675,$40 Big Stack $800 Guarantee
2244,1/20/2023 6:00:00 pm,Seminole Hard Rock Tampa,33610,NLH,200,160,40,0.8,NLH Quad Stack Double Green Chip Bounty
2245,1/20/2023 6:00:00 pm,Bonita Springs Poker Room,34135,NLH,130,100,30,0.7692307692307693,$130=P$100/H$15/S$10/J$5
2246,1/20/2023 6:30:00 pm,One-Eyed Jacks,59801,NLH,45,31,14,0.6888888888888889,$45 Friday Night Madness
2247,1/20/2023 6:30:00 pm,Derby Lane Poker Room,33702,NLH,80,62,18,0.775,$80 $2.5K GTE
2248,1/20/2023 6:45:00 pm,TGT Poker & Racebook,33604,NLH,80,61,19,0.7625,"$80 Fun Friday $7,500 Guarantee"
2249,1/20/2023 7:00:00 pm,Silks @ Tampa Bay Downs,33626,NLH,65,45,20,0.6923076923076923,"$65 Super Stack $1,500 GTD"
2250,1/20/2023 7:00:00 pm,Bonita Springs Poker Room,34135,NLOther,0,0,0,1.1,$300-$700 Evening high hand
2251,1/21/2023 9:30:00 am,Bonita Springs Poker Room,34135,NLH,0,0,0,1.1,$300-$700 Early Bird High Hand
2252,1/21/2023 11:00:00 am,Seminole Hard Rock Tampa,33610,NLH,400,330,70,0.825,No Limit Hold'em Deep Stack
2253,1/21/2023 11:00:00 am,Bonita Springs Poker Room,34135,NLH,200,165,35,0.825,$200=P$165/H$20/D10/J$5
2254,1/21/2023 12:00:00 pm,Derby Lane Poker Room,33702,NLH,125,106,19,0.848,$125 Green Chip Bounty
2255,1/21/2023 1:00:00 pm,Silks @ Tampa Bay Downs,33626,NLH,110,90,20,0.8181818181818182,$110 Super Stack $3K GTD
2256,1/21/2023 1:00:00 pm,One-Eyed Jacks,59801,NLH,140,120,20,0.8571428571428571,***$140 Double Board
2257,1/21/2023 2:00:00 pm,TGT Poker & Racebook,33604,NLH,50,33,17,0.66,$50 Mega Stack $1000 Guarantee
2258,1/14/2023 10:00:00 am,Black Pearl Casino,99216,NLH,25,20,5,0.8,NLH
2259,1/15/2023 10:00:00 am,Black Pearl Casino,99216,NLH,25,20,5,0.8,NLH
2260,1/15/2023 6:00:00 pm,Black Pearl Casino,99216,NLH,25,20,5,0.8,NLH
2261,1/16/2023 10:00:00 am,Black Pearl Casino,99216,NLH,25,20,5,0.8,NLH
2262,1/17/2023 10:00:00 am,Black Pearl Casino,99216,NLH,25,20,5,0.8,NLH
2263,1/17/2023 10:30:00 am,Lilac Lanes & Casino,99208,NLH,40,34,6,0.85,Bounty
2264,1/18/2023 10:00:00 am,Black Pearl Casino,99216,NLH,25,20,5,0.8,NLH
2265,1/19/2023 10:00:00 am,Black Pearl Casino,99216,NLH,25,20,5,0.8,NLH
2266,1/19/2023 6:00:00 pm,Black Pearl Casino,99216,NLH,25,20,5,0.8,NLH
2267,1/20/2023 10:00:00 am,Black Pearl Casino,99216,NLH,25,20,5,0.8,NLH
2268,1/21/2023 10:00:00 am,Black Pearl Casino,99216,NLH,25,20,5,0.8,NLH
2269,1/22/2023 10:00:00 am,Black Pearl Casino,99216,NLH,25,20,5,0.8,NLH
2270,1/22/2023 6:00:00 pm,Black Pearl Casino,99216,NLH,25,20,5,0.8,NLH
2271,1/23/2023 10:00:00 am,Black Pearl Casino,99216,NLH,25,20,5,0.8,NLH
2272,1/24/2023 10:00:00 am,Black Pearl Casino,99216,NLH,25,20,5,0.8,NLH
2273,1/24/2023 10:30:00 am,Lilac Lanes & Casino,99208,NLH,40,34,6,0.85,Bounty
2274,1/25/2023 10:00:00 am,Black Pearl Casino,99216,NLH,25,20,5,0.8,NLH
2275,1/26/2023 10:00:00 am,Black Pearl Casino,99216,NLH,25,20,5,0.8,NLH
2276,1/26/2023 6:00:00 pm,Black Pearl Casino,99216,NLH,25,20,5,0.8,NLH
2277,1/27/2023 10:00:00 am,Black Pearl Casino,99216,NLH,25,20,5,0.8,NLH
2278,1/28/2023 10:00:00 am,Black Pearl Casino,99216,NLH,25,20,5,0.8,NLH
2279,1/29/2023 10:00:00 am,Black Pearl Casino,99216,NLH,25,20,5,0.8,NLH
2280,1/29/2023 6:00:00 pm,Black Pearl Casino,99216,NLH,25,20,5,0.8,NLH
2281,1/30/2023 10:00:00 am,Black Pearl Casino,99216,NLH,25,20,5,0.8,NLH
2282,1/31/2023 10:00:00 am,Black Pearl Casino,99216,NLH,25,20,5,0.8,NLH
2283,1/31/2023 10:30:00 am,Lilac Lanes & Casino,99208,NLH,40,34,6,0.85,Bounty
2284,2/01/2023 10:00:00 am,Black Pearl Casino,99216,NLH,25,20,5,0.8,NLH
2285,2/02/2023 10:00:00 am,Black Pearl Casino,99216,NLH,25,20,5,0.8,NLH
2286,2/02/2023 6:00:00 pm,Black Pearl Casino,99216,NLH,25,20,5,0.8,NLH
2287,2/03/2023 10:00:00 am,Black Pearl Casino,99216,NLH,25,20,5,0.8,NLH
2288,2/04/2023 10:00:00 am,Black Pearl Casino,99216,NLH,25,20,5,0.8,NLH
2289,2/05/2023 10:00:00 am,Black Pearl Casino,99216,NLH,25,20,5,0.8,NLH
2290,2/05/2023 6:00:00 pm,Black Pearl Casino,99216,NLH,25,20,5,0.8,NLH
2291,2/06/2023 10:00:00 am,Black Pearl Casino,99216,NLH,25,20,5,0.8,NLH
2292,2/07/2023 10:00:00 am,Black Pearl Casino,99216,NLH,25,20,5,0.8,NLH
2293,2/07/2023 10:30:00 am,Lilac Lanes & Casino,99208,NLH,40,34,6,0.85,Bounty
2294,2/08/2023 10:00:00 am,Black Pearl Casino,99216,NLH,25,20,5,0.8,NLH
2295,2/09/2023 10:00:00 am,Black Pearl Casino,99216,NLH,25,20,5,0.8,NLH
2296,2/09/2023 6:00:00 pm,Black Pearl Casino,99216,NLH,25,20,5,0.8,NLH
2297,2/10/2023 10:00:00 am,Black Pearl Casino,99216,NLH,25,20,5,0.8,NLH
2298,2/11/2023 10:00:00 am,Black Pearl Casino,99216,NLH,25,20,5,0.8,NLH
2299,2/12/2023 10:00:00 am,Black Pearl Casino,99216,NLH,25,20,5,0.8,NLH
2300,2/12/2023 6:00:00 pm,Black Pearl Casino,99216,NLH,25,20,5,0.8,NLH
2301,2/13/2023 10:00:00 am,Black Pearl Casino,99216,NLH,25,20,5,0.8,NLH
2302,2/14/2023 10:00:00 am,Black Pearl Casino,99216,NLH,25,20,5,0.8,NLH
2303,2/14/2023 10:30:00 am,Lilac Lanes & Casino,99208,NLH,40,34,6,0.85,Bounty
2304,2/15/2023 10:00:00 am,Black Pearl Casino,99216,NLH,25,20,5,0.8,NLH
2305,2/16/2023 10:00:00 am,Black Pearl Casino,99216,NLH,25,20,5,0.8,NLH
2306,2/16/2023 6:00:00 pm,Black Pearl Casino,99216,NLH,25,20,5,0.8,NLH
2307,2/17/2023 10:00:00 am,Black Pearl Casino,99216,NLH,25,20,5,0.8,NLH
2308,2/18/2023 10:00:00 am,Black Pearl Casino,99216,NLH,25,20,5,0.8,NLH
2309,2/19/2023 10:00:00 am,Black Pearl Casino,99216,NLH,25,20,5,0.8,NLH
2310,2/19/2023 6:00:00 pm,Black Pearl Casino,99216,NLH,25,20,5,0.8,NLH
2311,2/20/2023 10:00:00 am,Black Pearl Casino,99216,NLH,25,20,5,0.8,NLH
2312,2/21/2023 10:00:00 am,Black Pearl Casino,99216,NLH,25,20,5,0.8,NLH
2313,2/21/2023 10:30:00 am,Lilac Lanes & Casino,99208,NLH,40,34,6,0.85,Bounty
2314,2/22/2023 10:00:00 am,Black Pearl Casino,99216,NLH,25,20,5,0.8,NLH
2315,2/23/2023 10:00:00 am,Black Pearl Casino,99216,NLH,25,20,5,0.8,NLH
2316,2/23/2023 6:00:00 pm,Black Pearl Casino,99216,NLH,25,20,5,0.8,NLH
2317,2/24/2023 10:00:00 am,Black Pearl Casino,99216,NLH,25,20,5,0.8,NLH
2318,2/25/2023 10:00:00 am,Black Pearl Casino,99216,NLH,25,20,5,0.8,NLH
2319,2/26/2023 10:00:00 am,Black Pearl Casino,99216,NLH,25,20,5,0.8,NLH
2320,2/26/2023 6:00:00 pm,Black Pearl Casino,99216,NLH,25,20,5,0.8,NLH
2321,2/27/2023 10:00:00 am,Black Pearl Casino,99216,NLH,25,20,5,0.8,NLH
2322,2/28/2023 10:00:00 am,Black Pearl Casino,99216,NLH,25,20,5,0.8,NLH
2323,2/28/2023 10:30:00 am,Lilac Lanes & Casino,99208,NLH,40,34,6,0.85,Bounty
2324,3/01/2023 10:00:00 am,Black Pearl Casino,99216,NLH,25,20,5,0.8,NLH
2325,3/02/2023 10:00:00 am,Black Pearl Casino,99216,NLH,25,20,5,0.8,NLH
2326,3/02/2023 6:00:00 pm,Black Pearl Casino,99216,NLH,25,20,5,0.8,NLH
2327,3/03/2023 10:00:00 am,Black Pearl Casino,99216,NLH,25,20,5,0.8,NLH
2328,3/04/2023 10:00:00 am,Black Pearl Casino,99216,NLH,25,20,5,0.8,NLH
2329,3/07/2023 10:00:00 am,Black Pearl Casino,99216,NLH,25,20,5,0.8,NLH
2330,3/07/2023 10:30:00 am,Lilac Lanes & Casino,99208,NLH,40,34,6,0.85,Bounty
2331,3/08/2023 10:00:00 am,Black Pearl Casino,99216,NLH,25,20,5,0.8,NLH
2332,3/09/2023 10:00:00 am,Black Pearl Casino,99216,NLH,25,20,5,0.8,NLH
2333,3/09/2023 6:00:00 pm,Black Pearl Casino,99216,NLH,25,20,5,0.8,NLH
2334,3/10/2023 10:00:00 am,Black Pearl Casino,99216,NLH,25,20,5,0.8,NLH
2335,3/11/2023 10:00:00 am,Black Pearl Casino,99216,NLH,25,20,5,0.8,NLH
2336,3/12/2023 10:00:00 am,Black Pearl Casino,99216,NLH,25,20,5,0.8,NLH
2337,3/12/2023 6:00:00 pm,Black Pearl Casino,99216,NLH,25,20,5,0.8,NLH
2338,3/13/2023 10:00:00 am,Black Pearl Casino,99216,NLH,25,20,5,0.8,NLH
2339,3/14/2023 10:00:00 am,Black Pearl Casino,99216,NLH,25,20,5,0.8,NLH
2340,3/14/2023 10:30:00 am,Lilac Lanes & Casino,99208,NLH,40,34,6,0.85,Bounty
2341,3/15/2023 10:00:00 am,Black Pearl Casino,99216,NLH,25,20,5,0.8,NLH
2342,1/14/2023 12:00:00 pm,Peppermill Poker Room,89502,NLH,235,200,35,0.851063829787234,No Limit Hold'em
2343,1/15/2023 12:00:00 pm,Peppermill Poker Room,89502,NLH,125,100,25,0.8,No Limit Hold'em
2344,1/21/2023 12:00:00 pm,Peppermill Poker Room,89502,NLH,235,200,35,0.851063829787234,No Limit Hold'em
2345,1/22/2023 12:00:00 pm,Peppermill Poker Room,89502,NLH,125,100,25,0.8,No Limit Hold'em
2346,1/14/2023 12:45:00 pm,Chicagoland Charity Poker,60056,NLH,50,40,10,0.8,Early Bird NLH
2347,1/14/2023 3:45:00 pm,Chicagoland Charity Poker,60056,NLH,50,40,10,0.8,Second Chance NLH
2348,1/14/2023 7:00:00 pm,Chicagoland Charity Poker,60056,NLH,130,100,30,0.7692307692307693,NLH
2349,1/14/2023 2:00:00 pm,Central Illinois Charitable Games,60462,NLH,50,40,10,0.8,Bloomington Moose Super Stack
2350,1/14/2023 2:00:00 pm,Chicago Charitable Games,60612,NLH,20,15,5,0.75,VFW Warrenville Early Bird
2351,1/14/2023 4:00:00 pm,Chicago Charitable Games,60612,NLH,120,100,20,0.8333333333333334,VFW Warrenville Saturday Stacks
2352,1/15/2023 12:00:00 pm,Grand Victoria Casino,60120,NLH,175,150,25,0.8571428571428571,NLH
2353,1/15/2023 2:00:00 pm,Four Winds South Bend,46614,NLH,100,80,20,0.8,NLH
2354,1/17/2023 12:00:00 pm,Horseshoe Casino Hammond,46320,NLH,120,90,30,0.75,$5K NLH
2355,1/17/2023 6:00:00 pm,Grand Victoria Casino,60120,NLH,115,100,15,0.8695652173913043,NLH
2356,1/18/2023 12:00:00 pm,Horseshoe Casino Hammond,46320,NLH,220,180,40,0.8181818181818182,$10K NLH
2357,1/18/2023 7:00:00 pm,Four Winds South Bend,46614,NLH,150,125,25,0.8333333333333334,NLH
2358,1/18/2023 6:00:00 pm,Grand Victoria Casino,60120,NLH,115,100,15,0.8695652173913043,NLH
2359,1/19/2023 6:00:00 pm,Horseshoe Casino Hammond,46320,NLH,120,90,30,0.75,$5K NLH
2360,1/21/2023 12:00:00 pm,Windy City Poker Championship,60462,NLH,110,80,30,0.7272727272727273,Deep Stack
2361,1/22/2023 12:00:00 pm,Grand Victoria Casino,60120,NLH,175,150,25,0.8571428571428571,NLH
2362,1/22/2023 2:00:00 pm,Four Winds South Bend,46614,NLH,100,80,20,0.8,NLH
2363,1/24/2023 12:00:00 pm,Horseshoe Casino Hammond,46320,NLH,120,90,30,0.75,$5K NLH
2364,1/24/2023 6:00:00 pm,Grand Victoria Casino,60120,NLH,115,100,15,0.8695652173913043,NLH
2365,1/25/2023 12:00:00 pm,Horseshoe Casino Hammond,46320,NLH,220,180,40,0.8181818181818182,$10K NLH
2366,1/25/2023 7:00:00 pm,Four Winds South Bend,46614,NLH,150,125,25,0.8333333333333334,NLH
2367,1/25/2023 6:00:00 pm,Grand Victoria Casino,60120,NLH,115,100,15,0.8695652173913043,NLH
2368,1/26/2023 6:00:00 pm,Horseshoe Casino Hammond,46320,NLH,120,90,30,0.75,$5K NLH
2369,1/29/2023 12:00:00 pm,Grand Victoria Casino,60120,NLH,175,150,25,0.8571428571428571,NLH
2370,1/29/2023 2:00:00 pm,Four Winds South Bend,46614,NLH,100,80,20,0.8,NLH
2371,1/31/2023 12:00:00 pm,Horseshoe Casino Hammond,46320,NLH,120,90,30,0.75,$5K NLH
2372,1/31/2023 6:00:00 pm,Grand Victoria Casino,60120,NLH,115,100,15,0.8695652173913043,NLH
2373,2/01/2023 12:00:00 pm,Horseshoe Casino Hammond,46320,NLH,220,180,40,0.8181818181818182,$10K NLH
2374,2/01/2023 7:00:00 pm,Four Winds South Bend,46614,NLH,150,125,25,0.8333333333333334,NLH
2375,2/01/2023 6:00:00 pm,Grand Victoria Casino,60120,NLH,115,100,15,0.8695652173913043,NLH
2376,2/02/2023 6:00:00 pm,Horseshoe Casino Hammond,46320,NLH,120,90,30,0.75,$5K NLH
2377,2/05/2023 12:00:00 pm,Grand Victoria Casino,60120,NLH,175,150,25,0.8571428571428571,NLH
2378,2/05/2023 2:00:00 pm,Four Winds South Bend,46614,NLH,100,80,20,0.8,NLH
2379,2/07/2023 12:00:00 pm,Horseshoe Casino Hammond,46320,NLH,120,90,30,0.75,$5K NLH
2380,2/07/2023 6:00:00 pm,Grand Victoria Casino,60120,NLH,115,100,15,0.8695652173913043,NLH
2381,2/08/2023 12:00:00 pm,Horseshoe Casino Hammond,46320,NLH,220,180,40,0.8181818181818182,$10K NLH
2382,2/08/2023 7:00:00 pm,Four Winds South Bend,46614,NLH,150,125,25,0.8333333333333334,NLH
2383,2/08/2023 6:00:00 pm,Grand Victoria Casino,60120,NLH,115,100,15,0.8695652173913043,NLH
2384,2/09/2023 6:00:00 pm,Horseshoe Casino Hammond,46320,NLH,120,90,30,0.75,$5K NLH
2385,2/12/2023 12:00:00 pm,Grand Victoria Casino,60120,NLH,175,150,25,0.8571428571428571,NLH
2386,2/12/2023 2:00:00 pm,Four Winds South Bend,46614,NLH,100,80,20,0.8,NLH
2387,2/14/2023 12:00:00 pm,Horseshoe Casino Hammond,46320,NLH,120,90,30,0.75,$5K NLH
2388,2/14/2023 6:00:00 pm,Grand Victoria Casino,60120,NLH,115,100,15,0.8695652173913043,NLH
2389,2/15/2023 12:00:00 pm,Horseshoe Casino Hammond,46320,NLH,220,180,40,0.8181818181818182,$10K NLH
2390,2/15/2023 7:00:00 pm,Four Winds South Bend,46614,NLH,150,125,25,0.8333333333333334,NLH
2391,2/15/2023 6:00:00 pm,Grand Victoria Casino,60120,NLH,115,100,15,0.8695652173913043,NLH
2392,2/16/2023 6:00:00 pm,Horseshoe Casino Hammond,46320,NLH,120,90,30,0.75,$5K NLH
2393,2/19/2023 12:00:00 pm,Grand Victoria Casino,60120,NLH,175,150,25,0.8571428571428571,NLH
2394,2/19/2023 2:00:00 pm,Four Winds South Bend,46614,NLH,100,80,20,0.8,NLH
2395,2/21/2023 12:00:00 pm,Horseshoe Casino Hammond,46320,NLH,120,90,30,0.75,$5K NLH
2396,2/21/2023 6:00:00 pm,Grand Victoria Casino,60120,NLH,115,100,15,0.8695652173913043,NLH
2397,2/22/2023 12:00:00 pm,Horseshoe Casino Hammond,46320,NLH,220,180,40,0.8181818181818182,$10K NLH
2398,2/22/2023 7:00:00 pm,Four Winds South Bend,46614,NLH,150,125,25,0.8333333333333334,NLH
2399,2/22/2023 6:00:00 pm,Grand Victoria Casino,60120,NLH,115,100,15,0.8695652173913043,NLH
2400,2/23/2023 6:00:00 pm,Horseshoe Casino Hammond,46320,NLH,120,90,30,0.75,$5K NLH
2401,1/14/2023 7:00:00 pm,Horseshoe Casino St. Louis,63102,NLH,125,100,25,0.8,No Limit Hold'em Bounty
2402,1/20/2023 7:00:00 pm,Horseshoe Casino St. Louis,63102,NLH,75,60,15,0.8,No Limit Hold'em
2403,1/21/2023 7:00:00 pm,Horseshoe Casino St. Louis,63102,NLH,125,100,25,0.8,No Limit Hold'em Bounty
2404,1/27/2023 7:00:00 pm,Horseshoe Casino St. Louis,63102,NLH,75,60,15,0.8,No Limit Hold'em
2405,1/28/2023 7:00:00 pm,Horseshoe Casino St. Louis,63102,NLH,125,100,25,0.8,No Limit Hold'em Bounty
2406,2/03/2023 7:00:00 pm,Horseshoe Casino St. Louis,63102,NLH,75,60,15,0.8,No Limit Hold'em
2407,2/04/2023 7:00:00 pm,Horseshoe Casino St. Louis,63102,NLH,125,100,25,0.8,No Limit Hold'em Bounty
2408,2/10/2023 7:00:00 pm,Horseshoe Casino St. Louis,63102,NLH,75,60,15,0.8,No Limit Hold'em
2409,2/11/2023 7:00:00 pm,Horseshoe Casino St. Louis,63102,NLH,125,100,25,0.8,No Limit Hold'em Bounty
2410,2/17/2023 7:00:00 pm,Horseshoe Casino St. Louis,63102,NLH,75,60,15,0.8,No Limit Hold'em
2411,2/18/2023 7:00:00 pm,Horseshoe Casino St. Louis,63102,NLH,125,100,25,0.8,No Limit Hold'em Bounty
2412,2/24/2023 7:00:00 pm,Horseshoe Casino St. Louis,63102,NLH,75,60,15,0.8,No Limit Hold'em
2413,2/25/2023 7:00:00 pm,Horseshoe Casino St. Louis,63102,NLH,125,100,25,0.8,No Limit Hold'em Bounty
2414,3/03/2023 7:00:00 pm,Horseshoe Casino St. Louis,63102,NLH,75,60,15,0.8,No Limit Hold'em
2415,3/04/2023 7:00:00 pm,Horseshoe Casino St. Louis,63102,NLH,125,100,25,0.8,No Limit Hold'em Bounty
2416,1/14/2023 11:15:00 am,Hard Rock Casino Cincinnati,45202,NLH,200,160,40,0.8,NLH
2417,1/14/2023 6:00:00 pm,Spades Social,45241,NLH,100,80,20,0.8,Triple Deep
2418,1/14/2023 6:00:00 pm,Mad River Poker Club,45424,NLH,120,60,60,0.5,W.S.O.P Series
2419,1/14/2023 6:00:00 pm,Ruggles Social Club,45430,NLH,60,40,20,0.6666666666666666,Saturday $3k GTD
2420,1/14/2023 6:15:00 pm,Hard Rock Casino Cincinnati,45202,NLH,200,160,40,0.8,NLH
2421,1/15/2023 10:15:00 am,Hard Rock Casino Cincinnati,45202,NLH,200,160,40,0.8,$10K NLH
2422,1/15/2023 2:00:00 pm,Spades Social,45241,NLH,30,25,5,0.8333333333333334,Red Chip Bingo Bounty
2423,1/15/2023 4:00:00 pm,Mad River Poker Club,45424,NLH,100,85,15,0.85,$2K GTD Green Chip Bounty
2424,1/15/2023 4:00:00 pm,Ruggles Social Club,45430,PLO,60,40,20,0.6666666666666666,$60 PLO Sunday Tourny
2425,1/15/2023 6:00:00 pm,Spades Social,45241,NLH,120,100,20,0.8333333333333334,$120 FREEZEOUT
2426,1/15/2023 6:15:00 pm,Hard Rock Casino Cincinnati,45202,NLH,100,75,25,0.75,NLH
2427,1/16/2023 10:15:00 am,Hard Rock Casino Cincinnati,45202,NLH,300,250,50,0.8333333333333334,Monthly Seniors NLH
2428,1/16/2023 6:00:00 pm,Mad River Poker Club,45424,NLH,40,30,10,0.75,$3K Monday Multiplier
2429,1/16/2023 6:15:00 pm,Hard Rock Casino Cincinnati,45202,NLH,100,75,25,0.75,NLH
2430,1/17/2023 10:15:00 am,Hard Rock Casino Cincinnati,45202,NLH,100,75,25,0.75,NLH
2431,1/17/2023 6:00:00 pm,Mad River Poker Club,45424,NLH,0,0,0,1.1,$4K GTD Free Roll
2432,1/17/2023 6:15:00 pm,Hard Rock Casino Cincinnati,45202,NLH,100,75,25,0.75,NLH
2433,1/18/2023 10:15:00 am,Hard Rock Casino Cincinnati,45202,NLH,100,75,25,0.75,NLH
2434,1/18/2023 6:00:00 pm,Mad River Poker Club,45424,NLH,60,50,10,0.8333333333333334,Satty To $500K GTD 1 Seat GTD
2435,1/18/2023 6:15:00 pm,Hard Rock Casino Cincinnati,45202,NLH,200,160,40,0.8,NLH
2436,1/19/2023 10:15:00 am,Hard Rock Casino Cincinnati,45202,NLH,100,75,25,0.75,NLH
2437,1/19/2023 6:00:00 pm,Mad River Poker Club,45424,NLH,120,60,60,0.5,W.S.O.P Series
2438,1/19/2023 6:15:00 pm,Hard Rock Casino Cincinnati,45202,NLH,100,75,25,0.75,NLH
2439,1/20/2023 10:15:00 am,Hard Rock Casino Cincinnati,45202,NLH,100,75,25,0.75,NLH
2440,1/20/2023 6:00:00 pm,Mad River Poker Club,45424,NLH,120,100,20,0.8333333333333334,$4K GTD Friday Freeze Out
2441,1/20/2023 6:15:00 pm,Hard Rock Casino Cincinnati,45202,NLH,200,160,40,0.8,NLH
2442,1/21/2023 11:15:00 am,Hard Rock Casino Cincinnati,45202,NLH,200,160,40,0.8,NLH
2443,1/21/2023 6:00:00 pm,Mad River Poker Club,45424,NLH,120,60,60,0.5,W.S.O.P Series
2444,1/21/2023 6:15:00 pm,Hard Rock Casino Cincinnati,45202,NLH,200,160,40,0.8,NLH
2445,1/22/2023 10:15:00 am,Hard Rock Casino Cincinnati,45202,NLH,200,160,40,0.8,$10K NLH
2446,1/22/2023 4:00:00 pm,Mad River Poker Club,45424,NLH,100,85,15,0.85,$2K GTD Green Chip Bounty
2447,1/22/2023 6:15:00 pm,Hard Rock Casino Cincinnati,45202,NLH,100,75,25,0.75,NLH
2448,1/23/2023 10:15:00 am,Hard Rock Casino Cincinnati,45202,NLH,100,75,25,0.75,NLH
2449,1/23/2023 6:00:00 pm,Mad River Poker Club,45424,NLH,40,30,10,0.75,$3K Monday Multiplier
2450,1/23/2023 6:15:00 pm,Hard Rock Casino Cincinnati,45202,NLH,100,75,25,0.75,NLH
2451,1/24/2023 10:15:00 am,Hard Rock Casino Cincinnati,45202,NLH,100,75,25,0.75,NLH
2452,1/24/2023 6:00:00 pm,Mad River Poker Club,45424,NLH,0,0,0,1.1,$4K GTD Free Roll
2453,1/24/2023 6:15:00 pm,Hard Rock Casino Cincinnati,45202,NLH,100,75,25,0.75,NLH
2454,1/25/2023 10:15:00 am,Hard Rock Casino Cincinnati,45202,NLH,100,75,25,0.75,NLH
2455,1/25/2023 6:00:00 pm,Mad River Poker Club,45424,NLH,60,50,10,0.8333333333333334,Satty To $500K GTD 1 Seat GTD
2456,1/25/2023 6:15:00 pm,Hard Rock Casino Cincinnati,45202,NLH,200,160,40,0.8,NLH
2457,1/26/2023 10:15:00 am,Hard Rock Casino Cincinnati,45202,NLH,100,75,25,0.75,NLH
2458,1/26/2023 6:00:00 pm,Mad River Poker Club,45424,NLH,120,60,60,0.5,W.S.O.P Series
2459,1/26/2023 6:15:00 pm,Hard Rock Casino Cincinnati,45202,NLH,100,75,25,0.75,NLH
2460,1/27/2023 10:15:00 am,Hard Rock Casino Cincinnati,45202,NLH,100,75,25,0.75,NLH
2461,1/27/2023 6:00:00 pm,Mad River Poker Club,45424,NLH,120,100,20,0.8333333333333334,$4K GTD Friday Freeze Out
2462,1/27/2023 6:15:00 pm,Hard Rock Casino Cincinnati,45202,NLH,200,160,40,0.8,NLH
2463,1/28/2023 11:15:00 am,Hard Rock Casino Cincinnati,45202,NLH,200,160,40,0.8,NLH
2464,1/28/2023 2:00:00 pm,Mad River Poker Club,45424,NLH,0,0,0,1.1,"$25,000 Free Roll"
2465,1/28/2023 6:00:00 pm,Mad River Poker Club,45424,NLH,120,60,60,0.5,W.S.O.P Series
2466,1/28/2023 6:15:00 pm,Hard Rock Casino Cincinnati,45202,NLH,200,160,40,0.8,NLH
2467,1/29/2023 10:15:00 am,Hard Rock Casino Cincinnati,45202,NLH,200,160,40,0.8,$10K NLH
2468,1/29/2023 4:00:00 pm,Mad River Poker Club,45424,NLH,100,85,15,0.85,$2K GTD Green Chip Bounty
2469,1/29/2023 6:15:00 pm,Hard Rock Casino Cincinnati,45202,NLH,100,75,25,0.75,NLH
2470,1/30/2023 10:15:00 am,Hard Rock Casino Cincinnati,45202,NLH,100,75,25,0.75,NLH
2471,1/30/2023 6:00:00 pm,Mad River Poker Club,45424,NLH,40,30,10,0.75,$3K Monday Multiplier
2472,1/30/2023 6:15:00 pm,Hard Rock Casino Cincinnati,45202,NLH,100,75,25,0.75,NLH
2473,1/31/2023 10:15:00 am,Hard Rock Casino Cincinnati,45202,NLH,100,75,25,0.75,NLH
2474,1/31/2023 6:00:00 pm,Mad River Poker Club,45424,NLH,0,0,0,1.1,$4K GTD Free Roll
2475,1/31/2023 6:15:00 pm,Hard Rock Casino Cincinnati,45202,NLH,100,75,25,0.75,NLH
2476,2/01/2023 10:15:00 am,Hard Rock Casino Cincinnati,45202,NLH,100,75,25,0.75,NLH
2477,2/01/2023 6:00:00 pm,Mad River Poker Club,45424,NLH,60,50,10,0.8333333333333334,Satty To $500K GTD 1 Seat GTD
2478,2/01/2023 6:15:00 pm,Hard Rock Casino Cincinnati,45202,NLH,200,160,40,0.8,NLH
2479,2/02/2023 10:15:00 am,Hard Rock Casino Cincinnati,45202,NLH,100,75,25,0.75,NLH
2480,2/02/2023 6:00:00 pm,Mad River Poker Club,45424,NLH,120,60,60,0.5,W.S.O.P Series
2481,2/02/2023 6:15:00 pm,Hard Rock Casino Cincinnati,45202,NLH,100,75,25,0.75,NLH
2482,2/03/2023 10:15:00 am,Hard Rock Casino Cincinnati,45202,NLH,100,75,25,0.75,NLH
2483,2/03/2023 3:00:00 pm,Mad River Poker Club,45424,NLH,500,425,75,0.85,"$500,000 GTD - Event #1 - $500,000 GTD Flight 1A"
2484,2/03/2023 6:15:00 pm,Hard Rock Casino Cincinnati,45202,NLH,200,160,40,0.8,NLH
2485,2/04/2023 11:15:00 am,Hard Rock Casino Cincinnati,45202,NLH,400,350,50,0.875,$50K 1st Saturday of the Month
2486,2/04/2023 12:00:00 pm,Mad River Poker Club,45424,NLH,500,425,75,0.85,"$500,000 GTD - Event #1 - $500,000 GTD Flight 1B"
2487,2/04/2023 6:15:00 pm,Hard Rock Casino Cincinnati,45202,NLH,200,160,40,0.8,NLH
2488,2/05/2023 10:15:00 am,Hard Rock Casino Cincinnati,45202,NLH,200,160,40,0.8,$10K NLH
2489,2/05/2023 12:00:00 pm,Mad River Poker Club,45424,NLH,500,425,75,0.85,"$500,000 GTD - Event #1 - $500,000 GTD Flight 1C"
2490,2/05/2023 6:15:00 pm,Hard Rock Casino Cincinnati,45202,NLH,100,75,25,0.75,NLH
2491,2/06/2023 10:15:00 am,Hard Rock Casino Cincinnati,45202,NLH,100,75,25,0.75,NLH
2492,2/06/2023 6:15:00 pm,Hard Rock Casino Cincinnati,45202,NLH,100,75,25,0.75,NLH
2493,2/07/2023 10:15:00 am,Hard Rock Casino Cincinnati,45202,NLH,100,75,25,0.75,NLH
2494,2/07/2023 6:15:00 pm,Hard Rock Casino Cincinnati,45202,NLH,100,75,25,0.75,NLH
2495,2/08/2023 10:15:00 am,Hard Rock Casino Cincinnati,45202,NLH,100,75,25,0.75,NLH
2496,2/08/2023 6:15:00 pm,Hard Rock Casino Cincinnati,45202,NLH,200,160,40,0.8,NLH
2497,2/09/2023 10:15:00 am,Hard Rock Casino Cincinnati,45202,NLH,100,75,25,0.75,NLH
2498,2/09/2023 3:00:00 pm,Mad River Poker Club,45424,NLH,500,425,75,0.85,"$500,000 GTD - Event #1 - $500,000 GTD Flight 1D"
2499,2/09/2023 6:15:00 pm,Hard Rock Casino Cincinnati,45202,NLH,100,75,25,0.75,NLH
2500,2/10/2023 10:15:00 am,Hard Rock Casino Cincinnati,45202,NLH,100,75,25,0.75,NLH
2501,2/10/2023 3:00:00 pm,Mad River Poker Club,45424,NLH,500,425,75,0.85,"$500,000 GTD - Event #1 - $500,000 GTD Flight 1E"
2502,2/10/2023 6:15:00 pm,Hard Rock Casino Cincinnati,45202,NLH,200,160,40,0.8,NLH
2503,2/11/2023 11:15:00 am,Hard Rock Casino Cincinnati,45202,NLH,200,160,40,0.8,NLH
2504,2/11/2023 12:00:00 pm,Mad River Poker Club,45424,NLH,500,425,75,0.85,"$500,000 GTD - Event #1 - $500,000 GTD Flight 1F"
2505,2/11/2023 6:15:00 pm,Hard Rock Casino Cincinnati,45202,NLH,200,160,40,0.8,NLH
2506,2/11/2023 7:30:00 pm,Mad River Poker Club,45424,NLH,500,425,75,0.85,"$500,000 GTD - Event #1 - $500,000 GTD Turbo Flight 1G"
2507,2/12/2023 10:15:00 am,Hard Rock Casino Cincinnati,45202,NLH,200,160,40,0.8,$10K NLH
2508,2/12/2023 12:00:00 pm,Mad River Poker Club,45424,NLH,500,425,75,0.85,"$500,000 GTD - Event #1 - $500,000 GTD Flight 1H"
2509,2/12/2023 6:15:00 pm,Hard Rock Casino Cincinnati,45202,NLH,100,75,25,0.75,NLH
2510,2/13/2023 10:15:00 am,Hard Rock Casino Cincinnati,45202,NLH,100,75,25,0.75,NLH
2511,2/13/2023 6:15:00 pm,Hard Rock Casino Cincinnati,45202,NLH,100,75,25,0.75,NLH
2512,2/14/2023 10:15:00 am,Hard Rock Casino Cincinnati,45202,NLH,100,75,25,0.75,NLH
2513,2/14/2023 6:15:00 pm,Hard Rock Casino Cincinnati,45202,NLH,100,75,25,0.75,NLH
2514,2/15/2023 10:15:00 am,Hard Rock Casino Cincinnati,45202,NLH,100,75,25,0.75,NLH
2515,2/15/2023 6:15:00 pm,Hard Rock Casino Cincinnati,45202,NLH,200,160,40,0.8,NLH
2516,2/16/2023 10:15:00 am,Hard Rock Casino Cincinnati,45202,NLH,100,75,25,0.75,NLH
2517,2/16/2023 3:00:00 pm,Mad River Poker Club,45424,NLH,500,425,75,0.85,"$500,000 GTD - Event #1 - $500,000 GTD Flight 1I"
2518,2/16/2023 6:15:00 pm,Hard Rock Casino Cincinnati,45202,NLH,100,75,25,0.75,NLH
2519,2/17/2023 10:15:00 am,Hard Rock Casino Cincinnati,45202,NLH,100,75,25,0.75,NLH
2520,2/17/2023 3:00:00 pm,Mad River Poker Club,45424,NLH,500,425,75,0.85,"$500,000 GTD - Event #1 - $500,000 GTD Flight 1J"
2521,2/17/2023 6:15:00 pm,Hard Rock Casino Cincinnati,45202,NLH,200,160,40,0.8,NLH
2522,2/18/2023 11:15:00 am,Hard Rock Casino Cincinnati,45202,NLH,200,160,40,0.8,NLH
2523,2/18/2023 12:00:00 pm,Mad River Poker Club,45424,NLH,500,425,75,0.85,"$500,000 GTD - Event #1 - $500,000 GTD Flight 1K"
2524,2/18/2023 6:15:00 pm,Hard Rock Casino Cincinnati,45202,NLH,200,160,40,0.8,NLH
2525,2/18/2023 7:30:00 pm,Mad River Poker Club,45424,NLH,500,425,75,0.85,"$500,000 GTD - Event #1 - $500,000 GTD Turbo Flight 1L"
2526,2/19/2023 10:15:00 am,Hard Rock Casino Cincinnati,45202,NLH,200,160,40,0.8,$10K NLH
2527,2/19/2023 6:15:00 pm,Hard Rock Casino Cincinnati,45202,NLH,100,75,25,0.75,NLH
2528,2/20/2023 10:15:00 am,Hard Rock Casino Cincinnati,45202,NLH,100,75,25,0.75,NLH
2529,2/20/2023 6:15:00 pm,Hard Rock Casino Cincinnati,45202,NLH,100,75,25,0.75,NLH
2530,2/21/2023 10:15:00 am,Hard Rock Casino Cincinnati,45202,NLH,100,75,25,0.75,NLH
2531,2/21/2023 6:15:00 pm,Hard Rock Casino Cincinnati,45202,NLH,100,75,25,0.75,NLH
2532,2/22/2023 10:15:00 am,Hard Rock Casino Cincinnati,45202,NLH,100,75,25,0.75,NLH
2533,2/22/2023 6:15:00 pm,Hard Rock Casino Cincinnati,45202,NLH,200,160,40,0.8,NLH
2534,2/23/2023 10:15:00 am,Hard Rock Casino Cincinnati,45202,NLH,100,75,25,0.75,NLH
2535,2/23/2023 6:15:00 pm,Hard Rock Casino Cincinnati,45202,NLH,100,75,25,0.75,NLH
2536,2/24/2023 10:15:00 am,Hard Rock Casino Cincinnati,45202,NLH,100,75,25,0.75,NLH
2537,2/24/2023 6:15:00 pm,Hard Rock Casino Cincinnati,45202,NLH,200,160,40,0.8,NLH
2538,2/25/2023 11:15:00 am,Hard Rock Casino Cincinnati,45202,NLH,200,160,40,0.8,NLH
2539,2/25/2023 6:15:00 pm,Hard Rock Casino Cincinnati,45202,NLH,200,160,40,0.8,NLH
2540,2/26/2023 10:15:00 am,Hard Rock Casino Cincinnati,45202,NLH,200,160,40,0.8,$10K NLH
2541,2/26/2023 6:15:00 pm,Hard Rock Casino Cincinnati,45202,NLH,100,75,25,0.75,NLH
2542,2/27/2023 6:15:00 pm,Hard Rock Casino Cincinnati,45202,NLH,100,75,25,0.75,NLH
2543,2/28/2023 6:15:00 pm,Hard Rock Casino Cincinnati,45202,NLH,100,75,25,0.75,NLH
2544,3/01/2023 10:15:00 am,Hard Rock Casino Cincinnati,45202,NLH,100,75,25,0.75,NLH
2545,3/01/2023 6:15:00 pm,Hard Rock Casino Cincinnati,45202,NLH,200,160,40,0.8,NLH
2546,3/02/2023 10:15:00 am,Hard Rock Casino Cincinnati,45202,NLH,100,75,25,0.75,NLH
2547,3/02/2023 6:15:00 pm,Hard Rock Casino Cincinnati,45202,NLH,100,75,25,0.75,NLH
2548,3/03/2023 10:15:00 am,Hard Rock Casino Cincinnati,45202,NLH,100,75,25,0.75,NLH
2549,3/03/2023 6:15:00 pm,Hard Rock Casino Cincinnati,45202,NLH,200,160,40,0.8,NLH
2550,3/04/2023 11:15:00 am,Hard Rock Casino Cincinnati,45202,NLH,400,350,50,0.875,$50K 1st Saturday of the Month
2551,3/04/2023 6:15:00 pm,Hard Rock Casino Cincinnati,45202,NLH,200,160,40,0.8,NLH
2552,3/05/2023 10:15:00 am,Hard Rock Casino Cincinnati,45202,NLH,200,160,40,0.8,$10K NLH
2553,3/05/2023 6:15:00 pm,Hard Rock Casino Cincinnati,45202,NLH,100,75,25,0.75,NLH
2554,3/06/2023 10:15:00 am,Hard Rock Casino Cincinnati,45202,NLH,100,75,25,0.75,NLH
2555,3/06/2023 6:15:00 pm,Hard Rock Casino Cincinnati,45202,NLH,100,75,25,0.75,NLH
2556,3/07/2023 10:15:00 am,Hard Rock Casino Cincinnati,45202,NLH,100,75,25,0.75,NLH
2557,3/07/2023 6:15:00 pm,Hard Rock Casino Cincinnati,45202,NLH,100,75,25,0.75,NLH
2558,3/08/2023 10:15:00 am,Hard Rock Casino Cincinnati,45202,NLH,100,75,25,0.75,NLH
2559,3/08/2023 6:15:00 pm,Hard Rock Casino Cincinnati,45202,NLH,200,160,40,0.8,NLH
2560,3/09/2023 10:15:00 am,Hard Rock Casino Cincinnati,45202,NLH,100,75,25,0.75,NLH
2561,3/09/2023 6:15:00 pm,Hard Rock Casino Cincinnati,45202,NLH,100,75,25,0.75,NLH
2562,3/10/2023 10:15:00 am,Hard Rock Casino Cincinnati,45202,NLH,100,75,25,0.75,NLH
2563,3/10/2023 6:15:00 pm,Hard Rock Casino Cincinnati,45202,NLH,200,160,40,0.8,NLH
2564,3/11/2023 11:15:00 am,Hard Rock Casino Cincinnati,45202,NLH,200,160,40,0.8,NLH
2565,3/11/2023 6:15:00 pm,Hard Rock Casino Cincinnati,45202,NLH,200,160,40,0.8,NLH
2566,3/12/2023 10:15:00 am,Hard Rock Casino Cincinnati,45202,NLH,200,160,40,0.8,$10K NLH
2567,3/12/2023 6:15:00 pm,Hard Rock Casino Cincinnati,45202,NLH,100,75,25,0.75,NLH
2568,3/13/2023 10:15:00 am,Hard Rock Casino Cincinnati,45202,NLH,100,75,25,0.75,NLH
2569,3/13/2023 6:15:00 pm,Hard Rock Casino Cincinnati,45202,NLH,100,75,25,0.75,NLH
2570,3/14/2023 6:15:00 pm,Hard Rock Casino Cincinnati,45202,NLH,100,75,25,0.75,NLH
2571,1/14/2023 12:00:00 pm,Horseshoe Indianapolis,46176,NLH,250,210,40,0.84,Black Chip Bounty NLH
2572,1/15/2023 12:00:00 pm,Horseshoe Indianapolis,46176,NLH,300,250,50,0.8333333333333334,$15K Deep Stack NLH
2573,1/16/2023 6:00:00 pm,Horseshoe Indianapolis,46176,NLH,100,75,25,0.75,Turbo NLH
2574,1/17/2023 6:00:00 pm,Horseshoe Indianapolis,46176,NLH,100,75,25,0.75,Green Chip Bounty
2575,1/18/2023 12:00:00 pm,Horseshoe Indianapolis,46176,NLH,100,75,25,0.75,Turbo NLH
2576,1/19/2023 6:00:00 pm,Horseshoe Indianapolis,46176,NLH,100,75,25,0.75,Turbo NLH
2577,1/20/2023 12:00:00 pm,Horseshoe Indianapolis,46176,NLH,100,75,25,0.75,Turbo NLH
2578,1/21/2023 12:00:00 pm,Horseshoe Indianapolis,46176,NLH,250,210,40,0.84,Black Chip Bounty NLH
2579,1/22/2023 12:00:00 pm,Horseshoe Indianapolis,46176,NLH,300,250,50,0.8333333333333334,$15K Deep Stack NLH
2580,1/23/2023 6:00:00 pm,Horseshoe Indianapolis,46176,NLH,100,75,25,0.75,Turbo NLH
2581,1/24/2023 6:00:00 pm,Horseshoe Indianapolis,46176,NLH,100,75,25,0.75,Green Chip Bounty
2582,1/25/2023 12:00:00 pm,Horseshoe Indianapolis,46176,NLH,100,75,25,0.75,Turbo NLH
2583,1/26/2023 6:00:00 pm,Horseshoe Indianapolis,46176,NLH,100,75,25,0.75,Turbo NLH
2584,1/27/2023 12:00:00 pm,Horseshoe Indianapolis,46176,NLH,100,75,25,0.75,Turbo NLH
2585,1/28/2023 12:00:00 pm,Horseshoe Indianapolis,46176,NLH,250,210,40,0.84,Black Chip Bounty NLH
2586,1/29/2023 12:00:00 pm,Horseshoe Indianapolis,46176,NLH,300,250,50,0.8333333333333334,$15K Deep Stack NLH
2587,1/30/2023 6:00:00 pm,Horseshoe Indianapolis,46176,NLH,100,75,25,0.75,Turbo NLH
2588,1/31/2023 6:00:00 pm,Horseshoe Indianapolis,46176,NLH,100,75,25,0.75,Green Chip Bounty
2589,2/01/2023 12:00:00 pm,Horseshoe Indianapolis,46176,NLH,100,75,25,0.75,Turbo NLH
2590,2/02/2023 6:00:00 pm,Horseshoe Indianapolis,46176,NLH,100,75,25,0.75,Turbo NLH
2591,2/03/2023 12:00:00 pm,Horseshoe Indianapolis,46176,NLH,100,75,25,0.75,Turbo NLH
2592,2/04/2023 12:00:00 pm,Horseshoe Indianapolis,46176,NLH,250,210,40,0.84,Black Chip Bounty NLH
2593,2/06/2023 6:00:00 pm,Horseshoe Indianapolis,46176,NLH,100,75,25,0.75,Turbo NLH
2594,2/07/2023 6:00:00 pm,Horseshoe Indianapolis,46176,NLH,100,75,25,0.75,Green Chip Bounty
2595,2/08/2023 12:00:00 pm,Horseshoe Indianapolis,46176,NLH,100,75,25,0.75,Turbo NLH
2596,2/09/2023 6:00:00 pm,Horseshoe Indianapolis,46176,NLH,100,75,25,0.75,Turbo NLH
2597,2/10/2023 12:00:00 pm,Horseshoe Indianapolis,46176,NLH,100,75,25,0.75,Turbo NLH
2598,2/11/2023 12:00:00 pm,Horseshoe Indianapolis,46176,NLH,250,210,40,0.84,Black Chip Bounty NLH
2599,2/12/2023 12:00:00 pm,Horseshoe Indianapolis,46176,NLH,300,250,50,0.8333333333333334,$15K Deep Stack NLH
2600,2/13/2023 6:00:00 pm,Horseshoe Indianapolis,46176,NLH,100,75,25,0.75,Turbo NLH
2601,2/14/2023 6:00:00 pm,Horseshoe Indianapolis,46176,NLH,100,75,25,0.75,Green Chip Bounty
2602,2/15/2023 12:00:00 pm,Horseshoe Indianapolis,46176,NLH,100,75,25,0.75,Turbo NLH
2603,2/16/2023 6:00:00 pm,Horseshoe Indianapolis,46176,NLH,100,75,25,0.75,Turbo NLH
2604,2/17/2023 12:00:00 pm,Horseshoe Indianapolis,46176,NLH,100,75,25,0.75,Turbo NLH
2605,2/18/2023 12:00:00 pm,Horseshoe Indianapolis,46176,NLH,250,210,40,0.84,Black Chip Bounty NLH
2606,2/19/2023 12:00:00 pm,Horseshoe Indianapolis,46176,NLH,300,250,50,0.8333333333333334,$15K Deep Stack NLH
2607,2/20/2023 6:00:00 pm,Horseshoe Indianapolis,46176,NLH,100,75,25,0.75,Turbo NLH
2608,2/21/2023 6:00:00 pm,Horseshoe Indianapolis,46176,NLH,100,75,25,0.75,Green Chip Bounty
2609,2/22/2023 12:00:00 pm,Horseshoe Indianapolis,46176,NLH,100,75,25,0.75,Turbo NLH
2610,2/23/2023 6:00:00 pm,Horseshoe Indianapolis,46176,NLH,100,75,25,0.75,Turbo NLH
2611,2/24/2023 12:00:00 pm,Horseshoe Indianapolis,46176,NLH,100,75,25,0.75,Turbo NLH
2612,2/25/2023 12:00:00 pm,Horseshoe Indianapolis,46176,NLH,250,210,40,0.84,Black Chip Bounty NLH
2613,2/26/2023 12:00:00 pm,Horseshoe Indianapolis,46176,NLH,300,250,50,0.8333333333333334,$15K Deep Stack NLH
2614,2/27/2023 6:00:00 pm,Horseshoe Indianapolis,46176,NLH,100,75,25,0.75,Turbo NLH
2615,2/28/2023 6:00:00 pm,Horseshoe Indianapolis,46176,NLH,100,75,25,0.75,Green Chip Bounty
2616,3/01/2023 12:00:00 pm,Horseshoe Indianapolis,46176,NLH,100,75,25,0.75,Turbo NLH
2617,3/02/2023 6:00:00 pm,Horseshoe Indianapolis,46176,NLH,100,75,25,0.75,Turbo NLH
2618,3/03/2023 12:00:00 pm,Horseshoe Indianapolis,46176,NLH,100,75,25,0.75,Turbo NLH
2619,3/04/2023 12:00:00 pm,Horseshoe Indianapolis,46176,NLH,250,210,40,0.84,Black Chip Bounty NLH
2620,3/05/2023 12:00:00 pm,Horseshoe Indianapolis,46176,NLH,300,250,50,0.8333333333333334,$15K Deep Stack NLH
2621,3/06/2023 6:00:00 pm,Horseshoe Indianapolis,46176,NLH,100,75,25,0.75,Turbo NLH
2622,3/07/2023 6:00:00 pm,Horseshoe Indianapolis,46176,NLH,100,75,25,0.75,Green Chip Bounty
2623,3/08/2023 12:00:00 pm,Horseshoe Indianapolis,46176,NLH,100,75,25,0.75,Turbo NLH
2624,3/09/2023 6:00:00 pm,Horseshoe Indianapolis,46176,NLH,100,75,25,0.75,Turbo NLH
2625,3/10/2023 12:00:00 pm,Horseshoe Indianapolis,46176,NLH,100,75,25,0.75,Turbo NLH
2626,3/11/2023 12:00:00 pm,Horseshoe Indianapolis,46176,NLH,250,210,40,0.84,Black Chip Bounty NLH
2627,3/12/2023 12:00:00 pm,Horseshoe Indianapolis,46176,NLH,300,250,50,0.8333333333333334,$15K Deep Stack NLH
2628,3/13/2023 6:00:00 pm,Horseshoe Indianapolis,46176,NLH,100,75,25,0.75,Turbo NLH
2629,3/14/2023 6:00:00 pm,Horseshoe Indianapolis,46176,NLH,100,75,25,0.75,Green Chip Bounty
2630,3/15/2023 12:00:00 pm,Horseshoe Indianapolis,46176,NLH,100,75,25,0.75,Turbo NLH
2631,1/14/2023 1:00:00 pm,Tri-State Social,42420,NLH,0,0,0,1.1,$1000 GTD NLT
2632,1/15/2023 3:00:00 pm,Caesars Southern Indiana,47117,NLH,105,83,22,0.7904761904761904,NLH w/Final Table Jackpot
2633,1/15/2023 2:00:00 pm,Tri-State Social,42420,NLH,150,125,25,0.8333333333333334,$150 Sunday Deepstack NLT
2634,1/16/2023 6:00:00 pm,Tri-State Social,42420,NLH,60,50,10,0.8333333333333334,$60 Monday Night Football NLT
2635,1/17/2023 7:00:00 pm,Tri-State Social,42420,NLH,120,100,20,0.8333333333333334,$120 Tuesday Freezout
2636,1/18/2023 7:00:00 pm,Caesars Southern Indiana,47117,NLH,100,83,17,0.83,Green Chip Bounty
2637,1/19/2023 12:00:00 pm,Caesars Southern Indiana,47117,NLH,70,53,17,0.7571428571428571,NLH
2638,1/19/2023 6:00:00 pm,Tri-State Social,42420,NLH,60,50,10,0.8333333333333334,$60 Thursday Night Football NLT Freezeout
2639,1/20/2023 7:00:00 pm,Tri-State Social,42420,NLH,35,30,5,0.8571428571428571,$25 Friday Night NLT
2640,1/21/2023 1:00:00 pm,Tri-State Social,42420,NLH,0,0,0,1.1,$1000 GTD NLT
2641,1/22/2023 3:00:00 pm,Caesars Southern Indiana,47117,NLH,105,83,22,0.7904761904761904,NLH w/Final Table Jackpot
2642,1/22/2023 2:00:00 pm,Tri-State Social,42420,NLH,150,125,25,0.8333333333333334,Sunday $150 Freezout
2643,1/23/2023 6:00:00 pm,Tri-State Social,42420,NLH,60,50,10,0.8333333333333334,$60 Monday Night Football NLT
2644,1/24/2023 7:00:00 pm,Tri-State Social,42420,NLH,120,100,20,0.8333333333333334,$120 Tuesday Freezout
2645,1/25/2023 7:00:00 pm,Caesars Southern Indiana,47117,NLH,100,83,17,0.83,Green Chip Bounty
2646,1/26/2023 12:00:00 pm,Caesars Southern Indiana,47117,NLH,70,53,17,0.7571428571428571,NLH
2647,1/26/2023 6:00:00 pm,Tri-State Social,42420,NLH,60,50,10,0.8333333333333334,$60 Thursday Night Football NLT Freezeout
2648,1/27/2023 6:00:00 pm,Tri-State Social,42420,NLH,400,340,60,0.85,January Deepstack Event - Event #3 - $400 Deepstack Day 1a
2649,1/28/2023 1:00:00 pm,Tri-State Social,42420,NLH,0,0,0,1.1,$1000 GTD NLT
2650,1/28/2023 6:00:00 pm,Tri-State Social,42420,NLH,400,340,60,0.85,January Deepstack Event - Event #3 - $400 Deepstack Day 1b
2651,1/29/2023 3:00:00 pm,Caesars Southern Indiana,47117,NLH,105,83,22,0.7904761904761904,NLH w/Final Table Jackpot
2652,1/30/2023 6:00:00 pm,Tri-State Social,42420,NLH,60,50,10,0.8333333333333334,$60 Monday Night Football NLT
2653,1/31/2023 7:00:00 pm,Tri-State Social,42420,NLH,120,100,20,0.8333333333333334,$120 Tuesday Freezout
2654,2/01/2023 7:00:00 pm,Caesars Southern Indiana,47117,NLH,100,83,17,0.83,Green Chip Bounty
2655,2/02/2023 12:00:00 pm,Caesars Southern Indiana,47117,NLH,70,53,17,0.7571428571428571,NLH
2656,2/05/2023 3:00:00 pm,Caesars Southern Indiana,47117,NLH,105,83,22,0.7904761904761904,NLH w/Final Table Jackpot
2657,2/08/2023 7:00:00 pm,Caesars Southern Indiana,47117,NLH,100,83,17,0.83,Green Chip Bounty
2658,2/09/2023 12:00:00 pm,Caesars Southern Indiana,47117,NLH,70,53,17,0.7571428571428571,NLH
2659,2/12/2023 3:00:00 pm,Caesars Southern Indiana,47117,NLH,105,83,22,0.7904761904761904,NLH w/Final Table Jackpot
2660,2/15/2023 7:00:00 pm,Caesars Southern Indiana,47117,NLH,100,83,17,0.83,Green Chip Bounty
2661,2/16/2023 12:00:00 pm,Caesars Southern Indiana,47117,NLH,70,53,17,0.7571428571428571,NLH
2662,2/19/2023 3:00:00 pm,Caesars Southern Indiana,47117,NLH,105,83,22,0.7904761904761904,NLH w/Final Table Jackpot
2663,2/22/2023 7:00:00 pm,Caesars Southern Indiana,47117,NLH,100,83,17,0.83,Green Chip Bounty
2664,2/23/2023 12:00:00 pm,Caesars Southern Indiana,47117,NLH,70,53,17,0.7571428571428571,NLH
2665,2/26/2023 3:00:00 pm,Caesars Southern Indiana,47117,NLH,105,83,22,0.7904761904761904,NLH w/Final Table Jackpot
2666,3/01/2023 7:00:00 pm,Caesars Southern Indiana,47117,NLH,100,83,17,0.83,Green Chip Bounty
2667,3/02/2023 12:00:00 pm,Caesars Southern Indiana,47117,NLH,70,53,17,0.7571428571428571,NLH
2668,3/05/2023 3:00:00 pm,Caesars Southern Indiana,47117,NLH,105,83,22,0.7904761904761904,NLH w/Final Table Jackpot
2669,3/08/2023 7:00:00 pm,Caesars Southern Indiana,47117,NLH,100,83,17,0.83,Green Chip Bounty
2670,3/09/2023 12:00:00 pm,Caesars Southern Indiana,47117,NLH,70,53,17,0.7571428571428571,NLH
2671,3/12/2023 3:00:00 pm,Caesars Southern Indiana,47117,NLH,105,83,22,0.7904761904761904,NLH w/Final Table Jackpot
2672,3/15/2023 7:00:00 pm,Caesars Southern Indiana,47117,NLH,100,83,17,0.83,Green Chip Bounty
2673,1/14/2023 11:00:00 am,Bally's Shreveport,71101,NLH,230,200,30,0.8695652173913043,No-Limit Hold'em
2674,1/16/2023 6:00:00 pm,Bally's Shreveport,71101,NLH,120,100,20,0.8333333333333334,No-Limit Hold'em Monday Monster Stack
2675,1/18/2023 12:00:00 pm,Bally's Shreveport,71101,NLH,130,105,25,0.8076923076923077,No-Limit Hold'em
2676,1/21/2023 11:00:00 am,Bally's Shreveport,71101,NLH,230,200,30,0.8695652173913043,No-Limit Hold'em
2677,1/23/2023 6:00:00 pm,Bally's Shreveport,71101,NLH,120,100,20,0.8333333333333334,No-Limit Hold'em Monday Monster Stack
2678,1/25/2023 12:00:00 pm,Bally's Shreveport,71101,NLH,130,105,25,0.8076923076923077,No-Limit Hold'em
2679,1/28/2023 11:00:00 am,Bally's Shreveport,71101,NLH,230,200,30,0.8695652173913043,No-Limit Hold'em
2680,1/30/2023 6:00:00 pm,Bally's Shreveport,71101,NLH,120,100,20,0.8333333333333334,No-Limit Hold'em Monday Monster Stack
2681,2/01/2023 12:00:00 pm,Bally's Shreveport,71101,NLH,130,105,25,0.8076923076923077,No-Limit Hold'em
2682,2/04/2023 11:00:00 am,Bally's Shreveport,71101,NLH,230,200,30,0.8695652173913043,No-Limit Hold'em
2683,2/06/2023 6:00:00 pm,Bally's Shreveport,71101,NLH,120,100,20,0.8333333333333334,No-Limit Hold'em Monday Monster Stack
2684,2/08/2023 12:00:00 pm,Bally's Shreveport,71101,NLH,130,105,25,0.8076923076923077,No-Limit Hold'em
2685,2/11/2023 11:00:00 am,Bally's Shreveport,71101,NLH,230,200,30,0.8695652173913043,No-Limit Hold'em
2686,2/13/2023 6:00:00 pm,Bally's Shreveport,71101,NLH,120,100,20,0.8333333333333334,No-Limit Hold'em Monday Monster Stack
2687,2/15/2023 12:00:00 pm,Bally's Shreveport,71101,NLH,130,105,25,0.8076923076923077,No-Limit Hold'em
2688,2/18/2023 11:00:00 am,Bally's Shreveport,71101,NLH,230,200,30,0.8695652173913043,No-Limit Hold'em
2689,2/20/2023 6:00:00 pm,Bally's Shreveport,71101,NLH,120,100,20,0.8333333333333334,No-Limit Hold'em Monday Monster Stack
2690,2/22/2023 12:00:00 pm,Bally's Shreveport,71101,NLH,130,105,25,0.8076923076923077,No-Limit Hold'em
2691,2/25/2023 11:00:00 am,Bally's Shreveport,71101,NLH,230,200,30,0.8695652173913043,No-Limit Hold'em
2692,2/27/2023 6:00:00 pm,Bally's Shreveport,71101,NLH,120,100,20,0.8333333333333334,No-Limit Hold'em Monday Monster Stack
2693,3/01/2023 12:00:00 pm,Bally's Shreveport,71101,NLH,130,105,25,0.8076923076923077,No-Limit Hold'em
2694,3/04/2023 11:00:00 am,Bally's Shreveport,71101,NLH,230,200,30,0.8695652173913043,No-Limit Hold'em
2695,3/06/2023 6:00:00 pm,Bally's Shreveport,71101,NLH,120,100,20,0.8333333333333334,No-Limit Hold'em Monday Monster Stack
2696,3/08/2023 12:00:00 pm,Bally's Shreveport,71101,NLH,130,105,25,0.8076923076923077,No-Limit Hold'em
2697,1/14/2023 11:00:00 am,Elks #155 Charity Casino,93445,NLH,50,40,10,0.8,Mega Rebuy
2698,1/14/2023 12:00:00 pm,Krazy Kopz at Vision Lanes,48185,MLO,100,100,"0% of total buy-in extracted for charity, per state law.",1.0,Pot-Limit Omaha
2699,1/14/2023 12:30:00 pm,Hollywood Casino at Greektown,48226,NLH,150,125,25,0.8333333333333334,Green Chip Bounty
2700,1/14/2023 1:00:00 pm,Rosemack Poker Room,48066,NLH,40,40,"5% of buy-in extracted for charity, per state law.",1.0,NLH
2701,1/14/2023 7:00:00 pm,Waterford Card Room at 300 Bowl,48328,NLH,100,100,"0% of buy-in extracted for charity, per state law.",1.0,2nd & 4th Saturday of the Month NLH
2702,1/14/2023 7:00:00 pm,Rosemack Poker Room,48066,NLH,70,70,"5% of buy-in extracted for charity, per state law.",1.0,NLH
2703,1/14/2023 7:00:00 pm,Krazy Kopz at Vision Lanes,48185,NLH,55,55,"0% of total buy-in extracted for charity, per state law.",1.0,NLH
2704,1/14/2023 7:00:00 pm,Legends Poker Place of Metamora,48455,NLH,20,20,"0% of buy-in extracted for charity, per state law.",1.0,NLH w/Rebuys
2705,1/14/2023 7:30:00 pm,Hollywood Casino at Greektown,48226,NLH,150,125,25,0.8333333333333334,NLH
2706,1/14/2023 7:30:00 pm,Momo's Poker Room,48180,NLH,35,35,"0% of total buy-in extracted for charity, per state law.",1.0,NLH
2707,1/15/2023 1:00:00 pm,Krazy Kopz at Vision Lanes,48185,NLH,55,55,"0% of total buy-in extracted for charity, per state law.",1.0,NLH
2708,1/15/2023 7:00:00 pm,Krazy Kopz at Vision Lanes,48185,NLH,45,45,"0% of total buy-in extracted for charity, per state law.",1.0,NLH
2709,1/15/2023 7:00:00 pm,One Eyed Jacks Poker Room,34233,NLH,60,60,5% of entry fee withheld per Michigan Charitable Gaming Law,1.0,Survivor ($225 payouts)
2710,1/15/2023 7:00:00 pm,Waterford Card Room at 300 Bowl,48328,NLH,45,45,"0% of buy-in extracted for charity, per state law.",1.0,NLH
2711,1/16/2023 1:00:00 pm,Ciccarelli's Sports Bar,48315,NLH,40,40,"5% of buy-in extracted for charity, per state law.",1.0,NLH
2712,1/14/2023 12:15:00 pm,FireKeepers Casino,49014,NLH,50,40,10,0.8,NLH
2713,1/14/2023 12:15:00 pm,FireKeepers Casino,49014,NLCRPI,50,40,10,0.8,Crazy Pineapple
2714,1/14/2023 2:00:00 pm,FireKeepers Casino,49014,NLH,100,90,10,0.9,Ladies Only Tournament
2715,1/14/2023 5:30:00 pm,The New Saginaw Poker Room,48603,NLH,100,90,10,0.9,NLH
2716,1/14/2023 6:15:00 pm,FireKeepers Casino,49014,NLH,125,105,20,0.84,Green Chip Bounty
2717,1/14/2023 7:00:00 pm,The Event Spot Poker Room,48917,NLH,45,45,"0% of buy-in extracted for charity, per state law.",1.0,NLH
2718,1/14/2023 7:00:00 pm,Corunna Poker Room,48867,NLH,90,90,"0% of total buy-in extracted for charity, per state law.",1.0,NLH w/single re-entry
2719,1/15/2023 12:15:00 pm,FireKeepers Casino,49014,NLH,200,170,30,0.85,NLH
2720,1/15/2023 6:15:00 pm,FireKeepers Casino,49014,NLPAPL,50,40,10,0.8,Pineapple
2721,1/16/2023 12:15:00 pm,FireKeepers Casino,49014,NLH,50,40,10,0.8,NLH
2722,1/16/2023 6:15:00 pm,FireKeepers Casino,49014,NLH,50,40,10,0.8,NLH
2723,1/17/2023 12:15:00 pm,FireKeepers Casino,49014,NLH,50,40,10,0.8,NLH
2724,1/17/2023 6:15:00 pm,FireKeepers Casino,49014,NLH,50,40,10,0.8,NLH
2725,1/18/2023 12:15:00 pm,FireKeepers Casino,49014,NLH,50,40,10,0.8,NLH
2726,1/18/2023 6:15:00 pm,FireKeepers Casino,49014,NLH,50,40,10,0.8,NLH
2727,1/18/2023 7:00:00 pm,The Event Spot Poker Room,48917,NLH,45,45,"0% of buy-in extracted for charity, per state law.",1.0,NLH
2728,1/19/2023 12:15:00 pm,FireKeepers Casino,49014,NLH,50,40,10,0.8,NLH
2729,1/19/2023 6:15:00 pm,FireKeepers Casino,49014,MLHA,65,45,20,0.6923076923076923,Round by Round (NLH-PLO Mix)
2730,1/19/2023 7:00:00 pm,The Event Spot Poker Room,48917,NLH,45,45,"0% of buy-in extracted for charity, per state law.",1.0,NLH
2731,1/19/2023 7:00:00 pm,Corunna Poker Room,48867,NLH,20,20,"0% of total buy-in extracted for charity, per state law.",1.0,NLH w/rebuys & add-on
2732,1/20/2023 12:15:00 pm,FireKeepers Casino,49014,NLH,50,40,10,0.8,NLH
2733,1/20/2023 6:15:00 pm,FireKeepers Casino,49014,NLH,95,75,20,0.7894736842105263,Mega Stack Turbo w/add-ons
2734,1/20/2023 7:00:00 pm,The Event Spot Poker Room,48917,NLH,100,100,"0% of buy-in extracted for charity, per state law.",1.0,1st & 3rd Friday of the Month NLH
2735,1/20/2023 7:00:00 pm,Corunna Poker Room,48867,NLH,50,50,"0% of total buy-in extracted for charity, per state law.",1.0,NLH w/single re-entry
2736,1/21/2023 12:15:00 pm,FireKeepers Casino,49014,NLH,50,40,10,0.8,NLH
2737,1/21/2023 12:15:00 pm,FireKeepers Casino,49014,NLCRPI,50,40,10,0.8,Crazy Pineapple
2738,1/21/2023 5:30:00 pm,The New Saginaw Poker Room,48603,NLH,100,90,10,0.9,NLH
2739,1/21/2023 6:15:00 pm,FireKeepers Casino,49014,NLH,125,105,20,0.84,Green Chip Bounty
2740,1/21/2023 7:00:00 pm,The Event Spot Poker Room,48917,NLH,45,45,"0% of buy-in extracted for charity, per state law.",1.0,NLH
2741,1/21/2023 7:00:00 pm,Corunna Poker Room,48867,NLH,90,90,"0% of total buy-in extracted for charity, per state law.",1.0,NLH w/single re-entry
2742,1/22/2023 12:15:00 pm,FireKeepers Casino,49014,NLH,200,170,30,0.85,NLH
2743,1/22/2023 6:15:00 pm,FireKeepers Casino,49014,NLPAPL,50,40,10,0.8,Pineapple
2744,1/23/2023 12:15:00 pm,FireKeepers Casino,49014,NLH,50,40,10,0.8,NLH
2745,1/23/2023 6:15:00 pm,FireKeepers Casino,49014,NLH,50,40,10,0.8,NLH
2746,1/15/2023 5:00:00 pm,Island Casino,49845,NLH,50,36,14,0.72,Midwest Poker Challenge Qualifier
2747,1/18/2023 6:30:00 pm,Island Casino,49845,NLH,60,46,14,0.7666666666666667,Great Lakes Summer Showdown Satellite
2748,1/19/2023 6:30:00 pm,Island Casino,49845,NLH,100,86,14,0.86,Super Satellite
2749,1/22/2023 5:00:00 pm,Island Casino,49845,NLH,50,36,14,0.72,Midwest Poker Challenge Qualifier
2750,1/25/2023 6:30:00 pm,Island Casino,49845,NLH,60,46,14,0.7666666666666667,Great Lakes Summer Showdown Satellite
2751,1/26/2023 6:30:00 pm,Island Casino,49845,NLH,100,86,14,0.86,Super Satellite
2752,1/28/2023 11:00:00 am,Island Casino,49845,NLH,10,0,10,0.0,Jewett Invitational
2753,1/29/2023 5:00:00 pm,Island Casino,49845,NLH,50,36,14,0.72,Midwest Poker Challenge Qualifier
2754,2/01/2023 6:30:00 pm,Island Casino,49845,NLH,60,46,14,0.7666666666666667,Great Lakes Summer Showdown Satellite
2755,2/02/2023 6:30:00 pm,Island Casino,49845,NLH,100,86,14,0.86,Super Satellite
2756,2/05/2023 5:00:00 pm,Island Casino,49845,NLH,50,36,14,0.72,Midwest Poker Challenge Qualifier
2757,2/08/2023 6:30:00 pm,Island Casino,49845,NLH,60,46,14,0.7666666666666667,Great Lakes Summer Showdown Satellite
2758,2/09/2023 6:30:00 pm,Island Casino,49845,NLH,100,86,14,0.86,Super Satellite
2759,2/12/2023 5:00:00 pm,Island Casino,49845,NLH,50,36,14,0.72,Midwest Poker Challenge Qualifier
2760,2/15/2023 6:30:00 pm,Island Casino,49845,NLH,60,46,14,0.7666666666666667,Great Lakes Summer Showdown Satellite
2761,2/16/2023 6:30:00 pm,Island Casino,49845,NLH,100,86,14,0.86,Super Satellite
2762,2/19/2023 5:00:00 pm,Island Casino,49845,NLH,50,36,14,0.72,Midwest Poker Challenge Qualifier
2763,2/22/2023 6:30:00 pm,Island Casino,49845,NLH,60,46,14,0.7666666666666667,Great Lakes Summer Showdown Satellite
2764,2/23/2023 6:30:00 pm,Island Casino,49845,NLH,100,86,14,0.86,Super Satellite
2765,2/26/2023 5:00:00 pm,Island Casino,49845,NLH,50,36,14,0.72,Midwest Poker Challenge Qualifier
2766,3/01/2023 6:30:00 pm,Island Casino,49845,NLH,60,46,14,0.7666666666666667,Great Lakes Summer Showdown Satellite
2767,3/02/2023 6:30:00 pm,Island Casino,49845,NLH,100,86,14,0.86,Super Satellite
2768,3/05/2023 5:00:00 pm,Island Casino,49845,NLH,50,36,14,0.72,Midwest Poker Challenge Qualifier
2769,3/08/2023 6:30:00 pm,Island Casino,49845,NLH,60,46,14,0.7666666666666667,Great Lakes Summer Showdown Satellite
2770,3/09/2023 6:30:00 pm,Island Casino,49845,NLH,100,86,14,0.86,Super Satellite
2771,3/12/2023 5:00:00 pm,Island Casino,49845,NLH,50,36,14,0.72,Midwest Poker Challenge Qualifier
2772,3/15/2023 6:30:00 pm,Island Casino,49845,NLH,60,46,14,0.7666666666666667,Great Lakes Summer Showdown Satellite
2773,1/14/2023 10:30:00 am,Canterbury Park,55379,NLH,350,298,52,0.8514285714285714,Second Saturday Deep Stack
2774,1/14/2023 11:00:00 am,Running Aces Casino & Racetrack,55025,NLH,800,700,100,0.875,Big Stack Avalanche - Series Event - Main Event
2775,1/14/2023 7:00:00 pm,Seven Clans Casino Warroad,56763,NLH,120,100,20,0.8333333333333334,No-Limit Hold'em
2776,1/15/2023 10:30:00 am,Canterbury Park,55379,NLH,150,115,35,0.7666666666666667,No-Limit Hold'em - Deep Stack
2777,1/15/2023 6:00:00 pm,Seven Clans Casino Warroad,56763,NLH,50,40,10,0.8,No-Limit Hold'em
2778,1/15/2023 6:30:00 pm,Canterbury Park,55379,NLH,85,61,24,0.7176470588235294,No-Limit Hold'em
2779,1/16/2023 10:00:00 am,Running Aces Casino & Racetrack,55025,NLCRPI,90,67,23,0.7444444444444445,The Crazy Pineapple
2780,1/16/2023 10:30:00 am,Canterbury Park,55379,NLH,85,61,24,0.7176470588235294,No-Limit Hold'em
2781,1/16/2023 6:00:00 pm,Running Aces Casino & Racetrack,55025,NLH,125,98,27,0.784,No-Limit Hold'em - $25 Bounty
2782,1/16/2023 6:30:00 pm,Canterbury Park,55379,NLH,150,121,29,0.8066666666666666,No-Limit Hold'em Double Green Chip Bounty
2783,1/17/2023 10:00:00 am,Running Aces Casino & Racetrack,55025,NLH,75,55,20,0.7333333333333333,The 75
2784,1/17/2023 10:30:00 am,Canterbury Park,55379,NLH,150,118,32,0.7866666666666666,No-Limit Hold'em Super Stack
2785,1/17/2023 6:00:00 pm,Running Aces Casino & Racetrack,55025,NLH,140,110,30,0.7857142857142857,The Extras NLH
2786,1/17/2023 6:30:00 pm,Canterbury Park,55379,NLH,120,92,28,0.7666666666666667,No-Limit Hold'em
2787,1/18/2023 10:30:00 am,Canterbury Park,55379,NLH,150,118,32,0.7866666666666666,No-Limit Hold'em Super Stack
2788,1/18/2023 6:00:00 pm,Running Aces Casino & Racetrack,55025,PLO,130,104,26,0.8,PLO
2789,1/18/2023 6:30:00 pm,Canterbury Park,55379,NLH,250,202,48,0.808,Double Stack NLH
2790,1/19/2023 10:00:00 am,Running Aces Casino & Racetrack,55025,NLH,90,67,23,0.7444444444444445,No-Limit Hold'em - The Splash Pots
2791,1/19/2023 6:00:00 pm,Running Aces Casino & Racetrack,55025,NLH,200,160,40,0.8,No-Limit Hold'em - Double Stack
2792,1/19/2023 6:30:00 pm,Canterbury Park,55379,NLH,150,118,32,0.7866666666666666,No-Limit Hold'em Super Stack NLH
2793,1/19/2023 7:00:00 pm,Seven Clans Casino Warroad,56763,NLH,50,40,10,0.8,No-Limit Hold'em
2794,1/20/2023 10:00:00 am,Running Aces Casino & Racetrack,55025,NLH,140,110,30,0.7857142857142857,The Extras NLH
2795,1/20/2023 10:30:00 am,Canterbury Park,55379,NLH,150,120,30,0.8,No-Limit Hold'em - $50 Bounty
2796,1/14/2023 10:30:00 am,Saloon No. 10,57732,NLH,9,6,3,0.6666666666666666,Six Shooter
2797,1/14/2023 12:00:00 pm,Cadillac Jack's Gaming Resort,57732,NLH,120,100,20,0.8333333333333334,Full Tilt No Limit Hold'em
2798,1/14/2023 12:00:00 pm,Silverado Franklin Casino,57732,NLH,78,70,8,0.8974358974358975,Saturday Deep Stack w/ Ticket
2799,1/15/2023 3:00:00 pm,Silverado Franklin Casino,57732,NLH,34,30,4,0.8823529411764706,Sunday Triple Stack
2800,1/16/2023 12:00:00 pm,Cadillac Jack's Gaming Resort,57732,NLH,60,50,10,0.8333333333333334,No-Limit Hold'em
2801,1/16/2023 6:30:00 pm,Silverado Franklin Casino,57732,NLH,112,100,12,0.8928571428571429,Greg and Cathys Tag Team Bounty
2802,1/17/2023 12:00:00 pm,Cadillac Jack's Gaming Resort,57732,NLH,60,50,10,0.8333333333333334,No-Limit Hold'em
2803,1/17/2023 6:30:00 pm,Cadillac Jack's Gaming Resort,57732,NLH,140,120,20,0.8571428571428571,No-Limit Hold'em
2804,1/17/2023 6:30:00 pm,Silverado Franklin Casino,57732,NLH,56,50,6,0.8928571428571429,Tuesday Re-buy Bounty
2805,1/18/2023 6:30:00 pm,Silverado Franklin Casino,57732,NLH,45,40,5,0.8888888888888888,Wednesday Re-Buy
2806,1/19/2023 6:30:00 pm,Silverado Franklin Casino,57732,NLH,89,80,9,0.898876404494382,Thursday Deep Stack
2807,1/20/2023 10:30:00 am,Saloon No. 10,57732,NLH,9,6,3,0.6666666666666666,Six Shooter
2808,1/20/2023 12:00:00 pm,Cadillac Jack's Gaming Resort,57732,NLH,60,50,10,0.8333333333333334,No-Limit Hold'em
2809,1/20/2023 12:00:00 pm,Silverado Franklin Casino,57732,NLH,78,70,8,0.8974358974358975,Friday Noon Deep Stack
2810,1/20/2023 6:30:00 pm,Silverado Franklin Casino,57732,NLH,166,150,16,0.9036144578313252,Friday Night Tournament w/ Ticket
2811,1/21/2023 10:30:00 am,Saloon No. 10,57732,NLH,9,6,3,0.6666666666666666,Six Shooter
2812,1/21/2023 12:00:00 pm,Cadillac Jack's Gaming Resort,57732,NLH,120,100,20,0.8333333333333334,Full Tilt No Limit Hold'em
2813,1/21/2023 12:00:00 pm,Silverado Franklin Casino,57732,NLH,78,70,8,0.8974358974358975,Saturday Deep Stack w/ Ticket
2814,1/22/2023 3:00:00 pm,Silverado Franklin Casino,57732,NLH,34,30,4,0.8823529411764706,Sunday Triple Stack
2815,1/23/2023 12:00:00 pm,Cadillac Jack's Gaming Resort,57732,NLH,60,50,10,0.8333333333333334,No-Limit Hold'em
2816,1/23/2023 6:30:00 pm,Silverado Franklin Casino,57732,NLH,112,100,12,0.8928571428571429,Monday Tag Team
2817,1/24/2023 12:00:00 pm,Cadillac Jack's Gaming Resort,57732,NLH,60,50,10,0.8333333333333334,No-Limit Hold'em
2818,1/24/2023 6:30:00 pm,Cadillac Jack's Gaming Resort,57732,NLH,140,120,20,0.8571428571428571,No-Limit Hold'em
2819,1/24/2023 6:30:00 pm,Silverado Franklin Casino,57732,NLH,56,50,6,0.8928571428571429,Tuesday Re-buy Bounty
2820,1/25/2023 6:30:00 pm,Silverado Franklin Casino,57732,NLH,45,40,5,0.8888888888888888,Wednesday Re-Buy
2821,1/26/2023 6:30:00 pm,Silverado Franklin Casino,57732,NLH,89,80,9,0.898876404494382,Thursday Deep Stack
2822,1/27/2023 10:30:00 am,Saloon No. 10,57732,NLH,9,6,3,0.6666666666666666,Six Shooter
2823,1/27/2023 12:00:00 pm,Cadillac Jack's Gaming Resort,57732,NLH,60,50,10,0.8333333333333334,No-Limit Hold'em
2824,1/27/2023 12:00:00 pm,Silverado Franklin Casino,57732,NLH,78,70,8,0.8974358974358975,Friday Noon Deep Stack
2825,1/27/2023 6:30:00 pm,Silverado Franklin Casino,57732,NLH,166,150,16,0.9036144578313252,Friday Night Tournament w/ Ticket
2826,1/28/2023 10:30:00 am,Saloon No. 10,57732,NLH,9,6,3,0.6666666666666666,Six Shooter
2827,1/28/2023 12:00:00 pm,Cadillac Jack's Gaming Resort,57732,NLH,120,100,20,0.8333333333333334,Full Tilt No Limit Hold'em
2828,1/28/2023 12:00:00 pm,Silverado Franklin Casino,57732,NLH,78,70,8,0.8974358974358975,Saturday Deep Stack w/ Ticket
2829,1/29/2023 3:00:00 pm,Silverado Franklin Casino,57732,NLH,34,30,4,0.8823529411764706,Sunday Triple Stack
2830,1/30/2023 12:00:00 pm,Cadillac Jack's Gaming Resort,57732,NLH,60,50,10,0.8333333333333334,No-Limit Hold'em
2831,1/30/2023 6:30:00 pm,Silverado Franklin Casino,57732,NLH,112,100,12,0.8928571428571429,Monday Tag Team
2832,1/31/2023 12:00:00 pm,Cadillac Jack's Gaming Resort,57732,NLH,60,50,10,0.8333333333333334,No-Limit Hold'em
2833,1/31/2023 6:30:00 pm,Cadillac Jack's Gaming Resort,57732,NLH,140,120,20,0.8571428571428571,No-Limit Hold'em
2834,1/31/2023 6:30:00 pm,Silverado Franklin Casino,57732,NLH,56,50,6,0.8928571428571429,Tuesday Re-buy Bounty
2835,2/01/2023 6:30:00 pm,Silverado Franklin Casino,57732,NLH,45,40,5,0.8888888888888888,Wednesday Re-Buy
2836,2/02/2023 6:30:00 pm,Silverado Franklin Casino,57732,NLH,89,80,9,0.898876404494382,Thursday Deep Stack
2837,2/03/2023 10:30:00 am,Saloon No. 10,57732,NLH,9,6,3,0.6666666666666666,Six Shooter
2838,2/03/2023 12:00:00 pm,Cadillac Jack's Gaming Resort,57732,NLH,60,50,10,0.8333333333333334,No-Limit Hold'em
2839,2/03/2023 12:00:00 pm,Silverado Franklin Casino,57732,NLH,78,70,8,0.8974358974358975,Friday Noon Deep Stack
2840,2/03/2023 6:30:00 pm,Silverado Franklin Casino,57732,NLH,166,150,16,0.9036144578313252,Friday Night Tournament w/ Ticket
2841,2/04/2023 10:30:00 am,Saloon No. 10,57732,NLH,9,6,3,0.6666666666666666,Six Shooter
2842,2/04/2023 12:00:00 pm,Cadillac Jack's Gaming Resort,57732,NLH,120,100,20,0.8333333333333334,Full Tilt No Limit Hold'em
2843,2/04/2023 12:00:00 pm,Silverado Franklin Casino,57732,NLH,78,70,8,0.8974358974358975,Saturday Deep Stack w/ Ticket
2844,2/05/2023 3:00:00 pm,Silverado Franklin Casino,57732,NLH,34,30,4,0.8823529411764706,Sunday Triple Stack
2845,2/06/2023 12:00:00 pm,Cadillac Jack's Gaming Resort,57732,NLH,60,50,10,0.8333333333333334,No-Limit Hold'em
2846,2/07/2023 12:00:00 pm,Cadillac Jack's Gaming Resort,57732,NLH,60,50,10,0.8333333333333334,No-Limit Hold'em
2847,2/07/2023 6:30:00 pm,Cadillac Jack's Gaming Resort,57732,NLH,140,120,20,0.8571428571428571,No-Limit Hold'em
2848,2/10/2023 10:30:00 am,Saloon No. 10,57732,NLH,9,6,3,0.6666666666666666,Six Shooter
2849,2/10/2023 12:00:00 pm,Cadillac Jack's Gaming Resort,57732,NLH,60,50,10,0.8333333333333334,No-Limit Hold'em
2850,1/15/2023 12:00:00 am,Caesars Palace,89109,NLH,100,75,25,0.75,No Limit Hold'em
2851,1/15/2023 9:00:00 am,Horseshoe Las Vegas,89109,NLH,75,50,25,0.6666666666666666,No Limit Hold'em
2852,1/15/2023 10:00:00 am,Caesars Palace,89109,NLH,100,75,25,0.75,No Limit Hold'em
2853,1/15/2023 10:05:00 am,South Point Casino,89183,NLH,60,43,17,0.7166666666666667,No Limit Hold'em
2854,1/15/2023 11:00:00 am,Horseshoe Las Vegas,89109,NLH,75,50,25,0.6666666666666666,No Limit Hold'em
2855,1/15/2023 11:00:00 am,MGM Grand,89109,NLH,100,75,25,0.75,No Limit Hold'em
2856,1/15/2023 11:05:00 am,The Orleans Casino,89103,NLH,200,148,52,0.74,Sunday Special No-Limit Hold'em
2857,1/15/2023 11:10:00 am,Venetian Casino,89109,NLH,400,333,67,0.8325,Deepstack Showdown Jan '23 - Event #13 - No Limit Hold'em EpicStack
2858,1/15/2023 12:00:00 pm,Wynn Casino,89109,NLH,400,345,55,0.8625,Wynn January Signature Series - Series Event - No Limit Hold'em
2859,1/15/2023 12:05:00 pm,Westgate Las Vegas Resort & Casino,89109,NLH,35,22,13,0.6285714285714286,*Sunday $35 NLH w/add-on
2860,1/15/2023 1:00:00 pm,Aria Casino,89158,NLH,160,125,35,0.78125,No Limit Hold'em
2861,1/15/2023 1:10:00 pm,Sahara Las Vegas,89109,NLH,75,65,10,0.8666666666666667,$75 NLHE Bounty
2862,1/15/2023 2:00:00 pm,Caesars Palace,89109,NLH,150,115,35,0.7666666666666667,No Limit Hold'em
2863,1/15/2023 2:00:00 pm,Horseshoe Las Vegas,89109,NLH,75,50,25,0.6666666666666666,No Limit Hold'em
2864,1/15/2023 2:00:00 pm,MGM Grand,89109,NLH,100,75,25,0.75,No Limit Hold'em Turbo
2865,1/15/2023 2:10:00 pm,Venetian Casino,89109,PLO,400,340,60,0.85,Deepstack Showdown Jan '23 - Event #14 - Pot Limit Omaha
2866,1/15/2023 4:05:00 pm,The Orleans Casino,89103,ROSE,200,158,42,0.79,R.O.S.E.
2867,1/15/2023 5:00:00 pm,Horseshoe Las Vegas,89109,NLH,75,50,25,0.6666666666666666,No Limit Hold'em
2868,1/15/2023 5:00:00 pm,Bellagio Casino,89109,NLH,160,125,35,0.78125,No Limit Hold'em
2869,1/15/2023 5:20:00 pm,Sahara Las Vegas,89109,NLCRPI,75,60,15,0.8,$75 Primetime Splash Pot Pineapple
2870,1/15/2023 6:00:00 pm,Caesars Palace,89109,NLH,100,75,25,0.75,No Limit Hold'em
2871,1/15/2023 6:05:00 pm,South Point Casino,89183,NLH,150,118,32,0.7866666666666666,No Limit Hold'em Deep Stack
2872,1/15/2023 7:00:00 pm,MGM Grand,89109,NLH,100,75,25,0.75,No Limit Hold'em
2873,1/15/2023 7:05:00 pm,Westgate Las Vegas Resort & Casino,89109,NLH,35,22,13,0.6285714285714286,*Sunday $35 NLH w/add-on
2874,1/15/2023 8:00:00 pm,Mandalay Bay,89119,NLH,60,40,20,0.6666666666666666,No Limit Hold'em
2875,1/15/2023 8:00:00 pm,Horseshoe Las Vegas,89109,NLH,75,50,25,0.6666666666666666,No Limit Hold'em
2876,1/15/2023 9:00:00 pm,Caesars Palace,89109,NLH,150,115,35,0.7666666666666667,No Limit Hold'em
2877,1/15/2023 9:30:00 pm,Sahara Las Vegas,89109,NLH,60,48,12,0.8,$60 NLHE Daily
2878,1/15/2023 10:05:00 pm,South Point Casino,89183,NLH,60,47,13,0.7833333333333333,No Limit Hold'em Turbo
2879,1/15/2023 11:00:00 pm,Horseshoe Las Vegas,89109,NLH,75,50,25,0.6666666666666666,No Limit Hold'em
2880,1/15/2023 11:59:00 pm,MGM Grand,89109,NLH,100,75,25,0.75,Midnight Maddness Hyper Turbo
2881,1/16/2023 12:00:00 am,Caesars Palace,89109,NLH,100,75,25,0.75,No Limit Hold'em
2882,1/16/2023 9:00:00 am,Horseshoe Las Vegas,89109,NLH,75,50,25,0.6666666666666666,No Limit Hold'em
2883,1/16/2023 10:00:00 am,Caesars Palace,89109,NLH,100,75,25,0.75,No Limit Hold'em
2884,1/16/2023 10:05:00 am,South Point Casino,89183,NLH,60,43,17,0.7166666666666667,No Limit Hold'em
2885,1/16/2023 11:00:00 am,Horseshoe Las Vegas,89109,NLH,75,50,25,0.6666666666666666,No Limit Hold'em
2886,1/16/2023 11:00:00 am,MGM Grand,89109,NLH,100,75,25,0.75,No Limit Hold'em
2887,1/16/2023 11:05:00 am,The Orleans Casino,89103,NLH,100,76,24,0.76,Super Stack No-Limit Hold'em
2888,1/16/2023 11:10:00 am,Venetian Casino,89109,NLH,400,333,67,0.8325,Deepstack Showdown Jan '23 - Event #15 - No Limit Hold'em EpicStack
2889,1/16/2023 12:00:00 pm,Aria Casino,89158,NLH,15700,15000,700,0.9554140127388536,2023 PokerGO Cup - Event #5 - NLH PokerGO Cup #5
2890,1/16/2023 12:00:00 pm,Wynn Casino,89109,NLH,500,430,70,0.86,Wynn January Signature Series - Series Event - No Limit Hold'em
2891,1/16/2023 12:10:00 pm,Sahara Las Vegas,89109,NLH,60,48,12,0.8,$60 NLHE Daily
2892,1/16/2023 1:00:00 pm,Aria Casino,89158,NLH,160,125,35,0.78125,No Limit Hold'em
2893,1/16/2023 2:00:00 pm,Caesars Palace,89109,NLH,150,115,35,0.7666666666666667,No Limit Hold'em
2894,1/16/2023 2:00:00 pm,Horseshoe Las Vegas,89109,NLH,75,50,25,0.6666666666666666,No Limit Hold'em
2895,1/16/2023 2:00:00 pm,MGM Grand,89109,NLH,100,75,25,0.75,No Limit Hold'em Turbo
2896,1/16/2023 2:05:00 pm,South Point Casino,89183,NLH,60,43,17,0.7166666666666667,No Limit Hold'em Turbo
2897,1/16/2023 4:05:00 pm,The Orleans Casino,89103,HORSE,125,98,27,0.784,H.O.R.S.E.
2898,1/16/2023 5:00:00 pm,Horseshoe Las Vegas,89109,NLH,75,50,25,0.6666666666666666,No Limit Hold'em
2899,1/16/2023 5:00:00 pm,Bellagio Casino,89109,NLH,160,125,35,0.78125,No Limit Hold'em
2900,1/16/2023 5:15:00 pm,Sahara Las Vegas,89109,NLCRPI,75,60,15,0.8,$75 Primetime Splash Pot Pineapple
2901,1/16/2023 6:00:00 pm,Caesars Palace,89109,NLH,100,75,25,0.75,No Limit Hold'em
2902,1/16/2023 6:05:00 pm,South Point Casino,89183,NLH,60,43,17,0.7166666666666667,No Limit Hold'em
2903,1/16/2023 6:10:00 pm,Venetian Casino,89109,NLH,300,250,50,0.8333333333333334,Deepstack Showdown Jan '23 - Event #16 - No Limit Hold'em Bounty
2904,1/16/2023 7:00:00 pm,MGM Grand,89109,NLH,100,75,25,0.75,No Limit Hold'em
2905,1/16/2023 7:05:00 pm,The Orleans Casino,89103,NLH,125,98,27,0.784,No Limit Crazy Pineapple
2906,1/16/2023 7:05:00 pm,Westgate Las Vegas Resort & Casino,89109,NLH,55,42,13,0.7636363636363637,*Monday $55 Bounty NLH
2907,1/16/2023 8:00:00 pm,Mandalay Bay,89119,NLH,60,40,20,0.6666666666666666,No Limit Hold'em
2908,1/16/2023 8:00:00 pm,Horseshoe Las Vegas,89109,NLH,75,50,25,0.6666666666666666,No Limit Hold'em
2909,1/16/2023 9:00:00 pm,Caesars Palace,89109,NLH,150,115,35,0.7666666666666667,No Limit Hold'em
2910,1/16/2023 9:30:00 pm,Sahara Las Vegas,89109,NLH,60,48,12,0.8,$60 NLHE Daily
2911,1/16/2023 10:05:00 pm,South Point Casino,89183,NLH,60,47,13,0.7833333333333333,No Limit Hold'em Turbo
2912,1/16/2023 11:00:00 pm,Horseshoe Las Vegas,89109,NLH,75,50,25,0.6666666666666666,No Limit Hold'em
2913,1/16/2023 11:59:00 pm,MGM Grand,89109,NLH,100,75,25,0.75,Midnight Maddness Hyper Turbo
2914,1/17/2023 12:00:00 am,Caesars Palace,89109,NLH,100,75,25,0.75,No Limit Hold'em
2915,1/17/2023 9:00:00 am,Horseshoe Las Vegas,89109,NLH,75,50,25,0.6666666666666666,No Limit Hold'em
2916,1/17/2023 10:00:00 am,Caesars Palace,89109,NLH,100,75,25,0.75,No Limit Hold'em
2917,1/17/2023 10:05:00 am,South Point Casino,89183,NLH,60,43,17,0.7166666666666667,No Limit Hold'em
2918,1/17/2023 11:00:00 am,Horseshoe Las Vegas,89109,NLH,75,50,25,0.6666666666666666,No Limit Hold'em
2919,1/17/2023 11:00:00 am,MGM Grand,89109,NLH,100,75,25,0.75,No Limit Hold'em
2920,1/17/2023 11:05:00 am,The Orleans Casino,89103,NLH,100,76,24,0.76,Super Stack No-Limit Hold'em
2921,1/17/2023 11:10:00 am,Venetian Casino,89109,NLH,400,333,67,0.8325,Deepstack Showdown Jan '23 - Event #17 - No Limit Hold'em EpicStack
2922,1/17/2023 12:00:00 pm,Aria Casino,89158,NLH,26000,25000,"1,000",0.9615384615384616,2023 PokerGO Cup - Event #6 - PokerGO Cup #6
2923,1/17/2023 12:00:00 pm,Wynn Casino,89109,NLH,600,520,80,0.8666666666666667,Wynn January Signature Series - Series Event - No Limit Hold'em
2924,1/17/2023 12:10:00 pm,Sahara Las Vegas,89109,NLH,60,48,12,0.8,$60 NLHE Daily
2925,1/17/2023 1:00:00 pm,Aria Casino,89158,NLH,160,125,35,0.78125,No Limit Hold'em
2926,1/17/2023 2:00:00 pm,Caesars Palace,89109,NLH,150,115,35,0.7666666666666667,No Limit Hold'em
2927,1/17/2023 2:00:00 pm,Horseshoe Las Vegas,89109,NLH,75,50,25,0.6666666666666666,No Limit Hold'em
2928,1/17/2023 2:00:00 pm,MGM Grand,89109,NLH,100,75,25,0.75,No Limit Hold'em Turbo
2929,1/17/2023 2:05:00 pm,South Point Casino,89183,FLO8,60,43,17,0.7166666666666667,Omaha 8/B
2930,1/17/2023 4:00:00 pm,Sahara Las Vegas,89109,NLCRPI,60,48,12,0.8,$60 NL Crazy Pineapple
2931,1/17/2023 5:00:00 pm,Horseshoe Las Vegas,89109,NLH,75,50,25,0.6666666666666666,No Limit Hold'em
2932,1/17/2023 5:00:00 pm,Bellagio Casino,89109,NLH,160,125,35,0.78125,No Limit Hold'em
2933,1/17/2023 6:00:00 pm,Caesars Palace,89109,NLH,100,75,25,0.75,No Limit Hold'em
2934,1/17/2023 6:05:00 pm,South Point Casino,89183,NLH,60,43,17,0.7166666666666667,No Limit Hold'em
2935,1/17/2023 6:10:00 pm,Venetian Casino,89109,NLH,300,250,50,0.8333333333333334,Deepstack Showdown Jan '23 - Event #18 - No Limit Hold'em Bounty
2936,1/17/2023 7:00:00 pm,MGM Grand,89109,NLH,100,75,25,0.75,No Limit Hold'em
2937,1/17/2023 7:05:00 pm,The Orleans Casino,89103,NLH,100,76,24,0.76,Super Stack No-Limit Hold'em
2938,1/17/2023 7:05:00 pm,Westgate Las Vegas Resort & Casino,89109,NLH,35,22,13,0.6285714285714286,*Tuesday $35 NLH
2939,1/17/2023 8:00:00 pm,Horseshoe Las Vegas,89109,NLH,75,50,25,0.6666666666666666,No Limit Hold'em
2940,1/17/2023 8:30:00 pm,Sahara Las Vegas,89109,NLH,60,48,12,0.8,$60 NLHE Daily
2941,1/17/2023 9:00:00 pm,Caesars Palace,89109,NLH,150,115,35,0.7666666666666667,No Limit Hold'em
2942,1/17/2023 10:05:00 pm,South Point Casino,89183,NLH,60,47,13,0.7833333333333333,No Limit Hold'em Turbo
2943,1/17/2023 11:00:00 pm,Horseshoe Las Vegas,89109,NLH,75,50,25,0.6666666666666666,No Limit Hold'em
2944,1/17/2023 11:59:00 pm,MGM Grand,89109,NLH,100,75,25,0.75,Midnight Maddness Hyper Turbo
2945,1/18/2023 12:00:00 am,Caesars Palace,89109,NLH,100,75,25,0.75,No Limit Hold'em
2946,1/18/2023 9:00:00 am,Horseshoe Las Vegas,89109,NLH,75,50,25,0.6666666666666666,No Limit Hold'em
2947,1/18/2023 10:00:00 am,Caesars Palace,89109,NLH,100,75,25,0.75,No Limit Hold'em
2948,1/18/2023 10:05:00 am,South Point Casino,89183,NLH,60,43,17,0.7166666666666667,No Limit Hold'em
2949,1/18/2023 11:00:00 am,Horseshoe Las Vegas,89109,NLH,75,50,25,0.6666666666666666,No Limit Hold'em
2950,1/18/2023 11:00:00 am,MGM Grand,89109,NLH,100,75,25,0.75,No Limit Hold'em
2951,1/18/2023 11:05:00 am,The Orleans Casino,89103,NLH,100,76,24,0.76,Super Stack No-Limit Hold'em
2952,1/18/2023 11:10:00 am,Venetian Casino,89109,NLH,400,333,67,0.8325,Deepstack Showdown Jan '23 - Event #19 - No Limit Hold'em EpicStack
2953,1/18/2023 12:00:00 pm,Aria Casino,89158,NLH,26000,25000,"1,000",0.9615384615384616,2023 PokerGO Cup - Event #7 - PokerGO Cup #7
2954,1/18/2023 12:00:00 pm,Wynn Casino,89109,NLH,600,520,80,0.8666666666666667,Wynn January Signature Series - Series Event - No Limit Hold'em
2955,1/18/2023 12:10:00 pm,Sahara Las Vegas,89109,NLH,60,48,12,0.8,$60 NLHE Daily
2956,1/18/2023 1:00:00 pm,Aria Casino,89158,NLH,160,125,35,0.78125,No Limit Hold'em
2957,1/18/2023 2:00:00 pm,Caesars Palace,89109,NLH,150,115,35,0.7666666666666667,No Limit Hold'em
2958,1/18/2023 2:00:00 pm,Horseshoe Las Vegas,89109,NLH,75,50,25,0.6666666666666666,No Limit Hold'em
2959,1/18/2023 2:00:00 pm,MGM Grand,89109,NLH,100,75,25,0.75,No Limit Hold'em Turbo
2960,1/18/2023 2:05:00 pm,South Point Casino,89183,NLH,60,43,17,0.7166666666666667,No Limit Hold'em Turbo
2961,1/18/2023 4:00:00 pm,Sahara Las Vegas,89109,NLCRPI,60,48,12,0.8,$60 NL Crazy Pineapple
2962,1/18/2023 4:05:00 pm,The Orleans Casino,89103,O8/S8,150,118,32,0.7866666666666666,Omaha 8/B / Stud 8
2963,1/18/2023 5:00:00 pm,Horseshoe Las Vegas,89109,NLH,75,50,25,0.6666666666666666,No Limit Hold'em
2964,1/18/2023 5:00:00 pm,Bellagio Casino,89109,NLH,160,125,35,0.78125,No Limit Hold'em
2965,1/18/2023 6:00:00 pm,Caesars Palace,89109,NLH,100,75,25,0.75,No Limit Hold'em
2966,1/18/2023 6:05:00 pm,South Point Casino,89183,NLH,150,118,32,0.7866666666666666,No Limit Hold'em Deep Stack
2967,1/18/2023 6:10:00 pm,Venetian Casino,89109,NLH,300,250,50,0.8333333333333334,Deepstack Showdown Jan '23 - Event #20 - No Limit Hold'em Bounty Survivor
2968,1/18/2023 7:00:00 pm,MGM Grand,89109,NLH,100,75,25,0.75,No Limit Hold'em
2969,1/18/2023 7:05:00 pm,The Orleans Casino,89103,NLH,125,100,25,0.8,No Limit Hold'em Survivor
2970,1/18/2023 7:05:00 pm,Westgate Las Vegas Resort & Casino,89109,NLH,55,42,13,0.7636363636363637,*Wednesday $55 Bounty NLH
2971,1/18/2023 8:00:00 pm,Horseshoe Las Vegas,89109,NLH,75,50,25,0.6666666666666666,No Limit Hold'em
2972,1/18/2023 8:30:00 pm,Sahara Las Vegas,89109,NLH,60,48,12,0.8,*$60 NLHE Daily
2973,1/18/2023 9:00:00 pm,Caesars Palace,89109,NLH,150,115,35,0.7666666666666667,No Limit Hold'em
2974,1/18/2023 10:05:00 pm,South Point Casino,89183,NLH,60,47,13,0.7833333333333333,No Limit Hold'em Turbo
2975,1/18/2023 11:00:00 pm,Horseshoe Las Vegas,89109,NLH,75,50,25,0.6666666666666666,No Limit Hold'em
2976,1/18/2023 11:59:00 pm,MGM Grand,89109,NLH,100,75,25,0.75,Midnight Maddness Hyper Turbo
2977,1/19/2023 12:00:00 am,Caesars Palace,89109,NLH,100,75,25,0.75,No Limit Hold'em
2978,1/19/2023 9:00:00 am,Horseshoe Las Vegas,89109,NLH,75,50,25,0.6666666666666666,No Limit Hold'em
2979,1/19/2023 10:00:00 am,Caesars Palace,89109,NLH,100,75,25,0.75,No Limit Hold'em
2980,1/19/2023 10:05:00 am,South Point Casino,89183,NLH,60,43,17,0.7166666666666667,No Limit Hold'em
2981,1/19/2023 11:00:00 am,Horseshoe Las Vegas,89109,NLH,75,50,25,0.6666666666666666,No Limit Hold'em
2982,1/19/2023 11:00:00 am,MGM Grand,89109,NLH,100,75,25,0.75,No Limit Hold'em
2983,1/19/2023 11:05:00 am,The Orleans Casino,89103,NLH,100,76,24,0.76,Super Stack No-Limit Hold'em
2984,1/19/2023 11:10:00 am,Venetian Casino,89109,NLH,500,422,78,0.844,Deepstack Showdown Jan '23 - Event #21 - No Limit Hold'em EpicStack
2985,1/19/2023 12:00:00 pm,Aria Casino,89158,NLH,52000,50000,"2,000",0.9615384615384616,2023 PokerGO Cup - Event #8 - PokerGO Cup #8
2986,1/19/2023 12:00:00 pm,Wynn Casino,89109,NLH,1100,975,125,0.8863636363636364,Wynn January Signature Series - Series Event - No Limit Hold'em
2987,1/19/2023 12:10:00 pm,Sahara Las Vegas,89109,NLH,60,48,12,0.8,$60 NLHE Daily
2988,1/19/2023 1:00:00 pm,Aria Casino,89158,NLH,160,125,35,0.78125,No Limit Hold'em
2989,1/19/2023 2:00:00 pm,Caesars Palace,89109,NLH,150,115,35,0.7666666666666667,No Limit Hold'em
2990,1/19/2023 2:00:00 pm,Horseshoe Las Vegas,89109,NLH,75,50,25,0.6666666666666666,No Limit Hold'em
2991,1/19/2023 2:00:00 pm,MGM Grand,89109,NLH,100,75,25,0.75,No Limit Hold'em Turbo
2992,1/19/2023 2:00:00 pm,South Point Casino,89183,O8/S8,150,118,32,0.7866666666666666,Omaha 8 / Stud 8
2993,1/19/2023 4:00:00 pm,Sahara Las Vegas,89109,NLCRPI,60,48,12,0.8,$60 NL Crazy Pineapple
2994,1/19/2023 5:00:00 pm,Horseshoe Las Vegas,89109,NLH,75,50,25,0.6666666666666666,No Limit Hold'em
2995,1/19/2023 5:00:00 pm,Bellagio Casino,89109,NLH,160,125,35,0.78125,No Limit Hold'em
2996,1/19/2023 5:00:00 pm,Wynn Casino,89109,NLH,200,165,35,0.825,"Wynn January Signature Series - Satellite - Milestone Satellite to $1,100 NLH"
2997,1/19/2023 6:00:00 pm,Caesars Palace,89109,NLH,100,75,25,0.75,No Limit Hold'em
2998,1/19/2023 6:05:00 pm,South Point Casino,89183,NLH,60,43,17,0.7166666666666667,No Limit Hold'em
2999,1/19/2023 6:10:00 pm,Venetian Casino,89109,NLH,300,250,50,0.8333333333333334,Deepstack Showdown Jan '23 - Event #22 - No Limit Hold'em Bounty
3000,1/19/2023 7:00:00 pm,MGM Grand,89109,NLH,100,75,25,0.75,No Limit Hold'em
3001,1/19/2023 7:05:00 pm,The Orleans Casino,89103,NLH,100,76,24,0.76,Super Stack No-Limit Hold'em
3002,1/19/2023 7:05:00 pm,Westgate Las Vegas Resort & Casino,89109,NLH,60,45,15,0.75,*Thursday $60 No limit Crazy Pineapple
3003,1/19/2023 8:00:00 pm,Mandalay Bay,89119,NLH,60,40,20,0.6666666666666666,No Limit Hold'em
3004,1/19/2023 8:00:00 pm,Horseshoe Las Vegas,89109,NLH,75,50,25,0.6666666666666666,No Limit Hold'em
3005,1/19/2023 8:30:00 pm,Sahara Las Vegas,89109,NLH,60,48,12,0.8,$60 NLHE Daily
3006,1/19/2023 9:00:00 pm,Caesars Palace,89109,NLH,150,115,35,0.7666666666666667,No Limit Hold'em
3007,1/19/2023 10:05:00 pm,South Point Casino,89183,NLH,60,47,13,0.7833333333333333,No Limit Hold'em Turbo
3008,1/19/2023 11:00:00 pm,Horseshoe Las Vegas,89109,NLH,75,50,25,0.6666666666666666,No Limit Hold'em
3009,1/19/2023 11:59:00 pm,MGM Grand,89109,NLH,100,75,25,0.75,Midnight Maddness Hyper Turbo
3010,1/20/2023 12:00:00 am,Caesars Palace,89109,NLH,100,75,25,0.75,No Limit Hold'em
3011,1/20/2023 9:00:00 am,Horseshoe Las Vegas,89109,NLH,75,50,25,0.6666666666666666,No Limit Hold'em
3012,1/20/2023 10:00:00 am,Caesars Palace,89109,NLH,100,75,25,0.75,No Limit Hold'em
3013,1/20/2023 10:05:00 am,South Point Casino,89183,NLH,60,43,17,0.7166666666666667,No Limit Hold'em
3014,1/20/2023 11:00:00 am,Horseshoe Las Vegas,89109,NLH,75,50,25,0.6666666666666666,No Limit Hold'em
3015,1/20/2023 11:00:00 am,MGM Grand,89109,NLH,100,75,25,0.75,No Limit Hold'em
3016,1/20/2023 11:05:00 am,The Orleans Casino,89103,NLH,100,76,24,0.76,Super Stack No-Limit Hold'em
3017,1/20/2023 11:10:00 am,Venetian Casino,89109,NLH,500,422,78,0.844,Deepstack Showdown Jan '23 - Event #23 - No Limit Hold'em EpicStack
3018,1/20/2023 12:00:00 pm,Wynn Casino,89109,NLH,1100,975,125,0.8863636363636364,Wynn January Signature Series - Series Event - No Limit Hold'em
3019,1/20/2023 12:10:00 pm,Sahara Las Vegas,89109,NLH,60,48,12,0.8,$60 NLHE Daily
3020,1/20/2023 1:00:00 pm,Aria Casino,89158,NLH,240,195,45,0.8125,No Limit Hold'em
3021,1/20/2023 2:00:00 pm,Caesars Palace,89109,NLH,150,115,35,0.7666666666666667,No Limit Hold'em
3022,1/20/2023 2:00:00 pm,Horseshoe Las Vegas,89109,NLH,75,50,25,0.6666666666666666,No Limit Hold'em
3023,1/20/2023 2:00:00 pm,MGM Grand,89109,NLH,100,75,25,0.75,No Limit Hold'em Turbo
3024,1/20/2023 2:05:00 pm,South Point Casino,89183,NLH,60,43,17,0.7166666666666667,No Limit Hold'em Turbo
3025,1/20/2023 2:10:00 pm,Venetian Casino,89109,PLO8,400,340,60,0.85,Deepstack Showdown Jan '23 - Event #24 - Pot Limit Omaha 8/B
3026,1/20/2023 4:00:00 pm,Sahara Las Vegas,89109,NLCRPI,60,48,12,0.8,$60 NL Crazy Pineapple
3027,1/20/2023 5:00:00 pm,Horseshoe Las Vegas,89109,NLH,75,50,25,0.6666666666666666,No Limit Hold'em
3028,1/20/2023 5:00:00 pm,Wynn Casino,89109,NLH,200,165,35,0.825,"Wynn January Signature Series - Satellite - Milestone Satellite to $1,100 NLH"
3029,1/20/2023 6:00:00 pm,Caesars Palace,89109,NLH,100,75,25,0.75,No Limit Hold'em
3030,1/20/2023 6:00:00 pm,South Point Casino,89183,NLH,150,118,32,0.7866666666666666,No Limit Hold'em Double Green Chip Bounty
3031,1/20/2023 6:30:00 pm,Poker Palace Casino,89030,NLH,20,10,10,0.5,No Limit Hold'em
3032,1/20/2023 7:00:00 pm,MGM Grand,89109,NLH,100,75,25,0.75,No Limit Hold'em
3033,1/20/2023 7:05:00 pm,The Orleans Casino,89103,NLH,150,118,32,0.7866666666666666,No-Limit Hold'em
3034,1/20/2023 7:05:00 pm,Westgate Las Vegas Resort & Casino,89109,NLH,35,22,13,0.6285714285714286,*Friday $35 NLH w/add-on
3035,1/20/2023 8:00:00 pm,Mandalay Bay,89119,NLH,60,40,20,0.6666666666666666,No Limit Hold'em
3036,1/20/2023 8:00:00 pm,Horseshoe Las Vegas,89109,NLH,75,50,25,0.6666666666666666,No Limit Hold'em
3037,1/20/2023 8:30:00 pm,Sahara Las Vegas,89109,NLH,60,48,12,0.8,$60 NLHE Daily
3038,1/20/2023 9:00:00 pm,Caesars Palace,89109,NLH,150,115,35,0.7666666666666667,No Limit Hold'em
3039,1/20/2023 10:05:00 pm,South Point Casino,89183,NLH,60,47,13,0.7833333333333333,No Limit Hold'em Turbo
3040,1/20/2023 11:00:00 pm,Horseshoe Las Vegas,89109,NLH,75,50,25,0.6666666666666666,No Limit Hold'em
3041,1/20/2023 11:59:00 pm,MGM Grand,89109,NLH,100,75,25,0.75,Midnight Maddness Hyper Turbo
3042,1/21/2023 12:00:00 am,Caesars Palace,89109,NLH,100,75,25,0.75,No Limit Hold'em
3043,1/21/2023 9:00:00 am,Horseshoe Las Vegas,89109,NLH,75,50,25,0.6666666666666666,No Limit Hold'em
3044,1/21/2023 10:00:00 am,Caesars Palace,89109,NLH,100,75,25,0.75,No Limit Hold'em
3045,1/21/2023 10:05:00 am,South Point Casino,89183,NLH,60,43,17,0.7166666666666667,No Limit Hold'em
3046,1/21/2023 11:00:00 am,Horseshoe Las Vegas,89109,NLH,75,50,25,0.6666666666666666,No Limit Hold'em
3047,1/21/2023 11:00:00 am,MGM Grand,89109,NLH,100,75,25,0.75,No Limit Hold'em
3048,1/21/2023 11:05:00 am,The Orleans Casino,89103,NLH,150,118,32,0.7866666666666666,No-Limit Hold'em Monster Stack
3049,1/21/2023 11:10:00 am,Venetian Casino,89109,NLH,500,422,78,0.844,Deepstack Showdown Jan '23 - Event #25 - No Limit Hold'em EpicStack
3050,1/21/2023 12:00:00 pm,Wynn Casino,89109,NLH,1100,975,125,0.8863636363636364,Wynn January Signature Series - Series Event - No Limit Hold'em
3051,1/21/2023 12:05:00 pm,Westgate Las Vegas Resort & Casino,89109,NLH,35,22,13,0.6285714285714286,Saturday $35 NLH w/add-on
3052,1/21/2023 12:10:00 pm,Sahara Las Vegas,89109,NLH,60,48,12,0.8,$60 NLHE Daily
3053,1/21/2023 1:00:00 pm,Aria Casino,89158,NLH,240,195,45,0.8125,No Limit Hold'em
3054,1/21/2023 2:00:00 pm,Caesars Palace,89109,NLH,150,115,35,0.7666666666666667,No Limit Hold'em
3055,1/21/2023 2:00:00 pm,Horseshoe Las Vegas,89109,NLH,160,115,45,0.71875,No Limit Hold'em Saturday
3056,1/21/2023 2:00:00 pm,MGM Grand,89109,NLH,100,75,25,0.75,No Limit Hold'em Turbo
3057,1/21/2023 2:05:00 pm,South Point Casino,89183,NLH,60,43,17,0.7166666666666667,No Limit Hold'em Turbo
3058,1/21/2023 2:10:00 pm,Venetian Casino,89109,FLO8,400,335,65,0.8375,Deepstack Showdown Jan '23 - Event #26 - Limit Omaha 8/B
3059,1/21/2023 3:05:00 pm,Resorts World Las Vegas,89109,NLH,160,130,30,0.8125,LADIES NLH $160 $3K GTD BY PLON
3060,1/21/2023 4:00:00 pm,MGM Grand,89109,PLO,150,120,30,0.8,Double Board Bomb Pot PLO
3061,1/21/2023 4:00:00 pm,Sahara Las Vegas,89109,NLCRPI,60,48,12,0.8,$60 NL Crazy Pineapple
3062,1/21/2023 5:00:00 pm,Horseshoe Las Vegas,89109,NLH,75,50,25,0.6666666666666666,No Limit Hold'em
3063,1/21/2023 6:00:00 pm,Caesars Palace,89109,NLH,100,75,25,0.75,No Limit Hold'em
3064,1/21/2023 6:05:00 pm,South Point Casino,89183,NLH,150,118,32,0.7866666666666666,No Limit Hold'em Deep Stack
3065,1/21/2023 6:30:00 pm,Poker Palace Casino,89030,NLH,20,10,10,0.5,No Limit Hold'em
3066,1/21/2023 7:00:00 pm,MGM Grand,89109,NLH,100,75,25,0.75,No Limit Hold'em
3067,1/21/2023 7:05:00 pm,The Orleans Casino,89103,NLH,220,188,32,0.8545454545454545,No Limit Hold'em Bounty
3068,1/21/2023 7:05:00 pm,Westgate Las Vegas Resort & Casino,89109,NLH,35,22,13,0.6285714285714286,Saturday $35 NLH w/add-on
3069,1/21/2023 8:00:00 pm,Horseshoe Las Vegas,89109,NLH,75,50,25,0.6666666666666666,No Limit Hold'em
3070,1/21/2023 8:00:00 pm,Mandalay Bay,89119,NLH,150,125,25,0.8333333333333334,No Limit Hold'em Saturday Night Classic
3071,1/21/2023 8:30:00 pm,Sahara Las Vegas,89109,NLH,60,48,12,0.8,$60 NLHE Daily
3072,1/21/2023 9:00:00 pm,Caesars Palace,89109,NLH,150,115,35,0.7666666666666667,No Limit Hold'em
3073,1/21/2023 10:05:00 pm,South Point Casino,89183,NLH,60,47,13,0.7833333333333333,No Limit Hold'em Turbo
3074,1/21/2023 11:00:00 pm,Horseshoe Las Vegas,89109,NLH,75,50,25,0.6666666666666666,No Limit Hold'em
3075,1/21/2023 11:59:00 pm,MGM Grand,89109,NLH,100,75,25,0.75,Midnight Maddness Hyper Turbo
3076,1/22/2023 12:00:00 am,Caesars Palace,89109,NLH,100,75,25,0.75,No Limit Hold'em
3077,1/22/2023 9:00:00 am,Horseshoe Las Vegas,89109,NLH,75,50,25,0.6666666666666666,No Limit Hold'em
3078,1/22/2023 10:00:00 am,Caesars Palace,89109,NLH,100,75,25,0.75,No Limit Hold'em
3079,1/22/2023 10:05:00 am,South Point Casino,89183,NLH,60,43,17,0.7166666666666667,No Limit Hold'em
3080,1/22/2023 11:00:00 am,Horseshoe Las Vegas,89109,NLH,75,50,25,0.6666666666666666,No Limit Hold'em
3081,1/22/2023 11:00:00 am,MGM Grand,89109,NLH,100,75,25,0.75,No Limit Hold'em
3082,1/22/2023 11:05:00 am,The Orleans Casino,89103,NLH,200,148,52,0.74,Sunday Special No-Limit Hold'em
3083,1/22/2023 11:10:00 am,Venetian Casino,89109,NLH,400,333,67,0.8325,Deepstack Showdown Jan '23 - Event #27 - No Limit Hold'em EpicStack
3084,1/22/2023 12:00:00 pm,Wynn Casino,89109,NLH,400,345,55,0.8625,Wynn January Signature Series - Series Event - No Limit Hold'em Progressive Bounty
3085,1/22/2023 12:05:00 pm,Westgate Las Vegas Resort & Casino,89109,NLH,35,22,13,0.6285714285714286,Sunday $35 NLH w/add-on
3086,1/22/2023 1:00:00 pm,Aria Casino,89158,NLH,160,125,35,0.78125,No Limit Hold'em
3087,1/22/2023 1:10:00 pm,Sahara Las Vegas,89109,NLH,75,65,10,0.8666666666666667,$75 NLHE Bounty
3088,1/22/2023 2:00:00 pm,Caesars Palace,89109,NLH,150,115,35,0.7666666666666667,No Limit Hold'em
3089,1/22/2023 2:00:00 pm,MGM Grand,89109,NLH,100,75,25,0.75,No Limit Hold'em Turbo
3090,1/22/2023 4:05:00 pm,The Orleans Casino,89103,ROSE,200,158,42,0.79,R.O.S.E.
3091,1/22/2023 5:00:00 pm,Horseshoe Las Vegas,89109,NLH,75,50,25,0.6666666666666666,No Limit Hold'em
3092,1/22/2023 5:00:00 pm,Bellagio Casino,89109,NLH,160,125,35,0.78125,No Limit Hold'em
3093,1/22/2023 5:20:00 pm,Sahara Las Vegas,89109,NLCRPI,75,60,15,0.8,$75 Primetime Splash Pot Pineapple
3094,1/22/2023 6:00:00 pm,Caesars Palace,89109,NLH,100,75,25,0.75,No Limit Hold'em
3095,1/22/2023 6:05:00 pm,South Point Casino,89183,NLH,150,118,32,0.7866666666666666,No Limit Hold'em Deep Stack
3096,1/22/2023 6:10:00 pm,Venetian Casino,89109,NLH,300,250,50,0.8333333333333334,Deepstack Showdown Jan '23 - Event #28 - No Limit Hold'em Bounty
3097,1/22/2023 7:00:00 pm,MGM Grand,89109,NLH,100,75,25,0.75,No Limit Hold'em
3098,1/22/2023 7:05:00 pm,Westgate Las Vegas Resort & Casino,89109,NLH,35,22,13,0.6285714285714286,Sunday $35 NLH w/add-on
3099,1/22/2023 8:00:00 pm,Mandalay Bay,89119,NLH,60,40,20,0.6666666666666666,No Limit Hold'em
3100,1/22/2023 8:00:00 pm,Horseshoe Las Vegas,89109,NLH,75,50,25,0.6666666666666666,No Limit Hold'em
3101,1/22/2023 9:00:00 pm,Caesars Palace,89109,NLH,150,115,35,0.7666666666666667,No Limit Hold'em
3102,1/22/2023 9:30:00 pm,Sahara Las Vegas,89109,NLH,60,48,12,0.8,$60 NLHE Daily
3103,1/22/2023 10:05:00 pm,South Point Casino,89183,NLH,60,47,13,0.7833333333333333,No Limit Hold'em Turbo
3104,1/22/2023 11:00:00 pm,Horseshoe Las Vegas,89109,NLH,75,50,25,0.6666666666666666,No Limit Hold'em
3105,1/22/2023 11:59:00 pm,MGM Grand,89109,NLH,100,75,25,0.75,Midnight Maddness Hyper Turbo
3106,1/23/2023 12:00:00 am,Caesars Palace,89109,NLH,100,75,25,0.75,No Limit Hold'em
3107,1/23/2023 9:00:00 am,Horseshoe Las Vegas,89109,NLH,75,50,25,0.6666666666666666,No Limit Hold'em
3108,1/23/2023 10:00:00 am,Caesars Palace,89109,NLH,100,75,25,0.75,No Limit Hold'em
3109,1/23/2023 10:05:00 am,South Point Casino,89183,NLH,60,43,17,0.7166666666666667,No Limit Hold'em
3110,1/23/2023 11:00:00 am,Horseshoe Las Vegas,89109,NLH,75,50,25,0.6666666666666666,No Limit Hold'em
3111,1/23/2023 11:00:00 am,MGM Grand,89109,NLH,100,75,25,0.75,No Limit Hold'em
3112,1/23/2023 11:05:00 am,The Orleans Casino,89103,NLH,100,76,24,0.76,Super Stack No-Limit Hold'em
3113,1/23/2023 11:10:00 am,Venetian Casino,89109,NLH,400,330,70,0.825,Deepstack Showdown Jan '23 - Event #29 - No Limit Hold'em UltimateStack
3114,1/23/2023 12:00:00 pm,Wynn Casino,89109,NLH,200,165,35,0.825,No Limit Hold'em
3115,1/23/2023 12:10:00 pm,Sahara Las Vegas,89109,NLH,60,48,12,0.8,$60 NLHE Daily
3116,1/23/2023 1:00:00 pm,Aria Casino,89158,NLH,160,125,35,0.78125,No Limit Hold'em
3117,1/23/2023 2:00:00 pm,Horseshoe Las Vegas,89109,NLH,75,50,25,0.6666666666666666,No Limit Hold'em
3118,1/23/2023 2:00:00 pm,Caesars Palace,89109,NLH,150,115,35,0.7666666666666667,No Limit Hold'em
3119,1/23/2023 2:00:00 pm,MGM Grand,89109,NLH,100,75,25,0.75,No Limit Hold'em Turbo
3120,1/23/2023 2:05:00 pm,South Point Casino,89183,NLH,60,43,17,0.7166666666666667,No Limit Hold'em Turbo
3121,1/23/2023 4:00:00 pm,Sahara Las Vegas,89109,NLCRPI,60,48,12,0.8,$60 NL Crazy Pineapple
3122,1/23/2023 4:05:00 pm,The Orleans Casino,89103,HORSE,125,98,27,0.784,H.O.R.S.E.
3123,1/23/2023 5:00:00 pm,Horseshoe Las Vegas,89109,NLH,75,50,25,0.6666666666666666,No Limit Hold'em
3124,1/23/2023 5:00:00 pm,Bellagio Casino,89109,NLH,160,125,35,0.78125,No Limit Hold'em
3125,1/23/2023 6:00:00 pm,Caesars Palace,89109,NLH,100,75,25,0.75,No Limit Hold'em
3126,1/23/2023 6:05:00 pm,South Point Casino,89183,NLH,60,43,17,0.7166666666666667,No Limit Hold'em
3127,1/23/2023 6:10:00 pm,Venetian Casino,89109,NLH,300,250,50,0.8333333333333334,Deepstack Showdown Jan '23 - Event #30 - No Limit Hold'em Bounty
3128,1/23/2023 7:00:00 pm,MGM Grand,89109,NLH,100,75,25,0.75,No Limit Hold'em
3129,1/23/2023 7:05:00 pm,The Orleans Casino,89103,NLH,125,98,27,0.784,No Limit Crazy Pineapple
3130,1/23/2023 7:05:00 pm,Westgate Las Vegas Resort & Casino,89109,NLH,55,42,13,0.7636363636363637,**Monday $55 Bounty NLH
3131,1/23/2023 8:00:00 pm,Mandalay Bay,89119,NLH,60,40,20,0.6666666666666666,No Limit Hold'em
3132,1/23/2023 8:00:00 pm,Horseshoe Las Vegas,89109,NLH,75,50,25,0.6666666666666666,No Limit Hold'em
3133,1/23/2023 8:30:00 pm,Sahara Las Vegas,89109,NLH,60,48,12,0.8,$60 NLHE Daily
3134,1/23/2023 9:00:00 pm,Caesars Palace,89109,NLH,150,115,35,0.7666666666666667,No Limit Hold'em
3135,1/23/2023 10:05:00 pm,South Point Casino,89183,NLH,60,47,13,0.7833333333333333,No Limit Hold'em Turbo
3136,1/23/2023 11:00:00 pm,Horseshoe Las Vegas,89109,NLH,75,50,25,0.6666666666666666,No Limit Hold'em
3137,1/23/2023 11:59:00 pm,MGM Grand,89109,NLH,100,75,25,0.75,Midnight Maddness Hyper Turbo
3138,1/24/2023 12:00:00 am,Caesars Palace,89109,NLH,100,75,25,0.75,No Limit Hold'em
3139,1/24/2023 9:00:00 am,Horseshoe Las Vegas,89109,NLH,75,50,25,0.6666666666666666,No Limit Hold'em
3140,1/24/2023 10:00:00 am,Caesars Palace,89109,NLH,100,75,25,0.75,No Limit Hold'em
3141,1/24/2023 10:05:00 am,South Point Casino,89183,NLH,60,43,17,0.7166666666666667,No Limit Hold'em
3142,1/24/2023 11:00:00 am,Horseshoe Las Vegas,89109,NLH,75,50,25,0.6666666666666666,No Limit Hold'em
3143,1/24/2023 11:00:00 am,MGM Grand,89109,NLH,100,75,25,0.75,No Limit Hold'em
3144,1/24/2023 11:05:00 am,The Orleans Casino,89103,NLH,100,76,24,0.76,Super Stack No-Limit Hold'em
3145,1/24/2023 11:10:00 am,Venetian Casino,89109,NLH,400,330,70,0.825,Deepstack Showdown Jan '23 - Event #29 - No Limit Hold'em UltimateStack
3146,1/24/2023 12:00:00 pm,Wynn Casino,89109,NLH,200,165,35,0.825,No Limit Hold'em
3147,1/24/2023 12:10:00 pm,Sahara Las Vegas,89109,NLH,60,48,12,0.8,$60 NLHE Daily
3148,1/24/2023 1:00:00 pm,Aria Casino,89158,NLH,160,125,35,0.78125,No Limit Hold'em
3149,1/24/2023 2:00:00 pm,Horseshoe Las Vegas,89109,NLH,75,50,25,0.6666666666666666,No Limit Hold'em
3150,1/24/2023 2:00:00 pm,Caesars Palace,89109,NLH,150,115,35,0.7666666666666667,No Limit Hold'em
3151,1/24/2023 2:00:00 pm,MGM Grand,89109,NLH,100,75,25,0.75,No Limit Hold'em Turbo
3152,1/24/2023 2:05:00 pm,South Point Casino,89183,FLO8,60,43,17,0.7166666666666667,Omaha 8/B
3153,1/24/2023 4:00:00 pm,Sahara Las Vegas,89109,NLCRPI,60,48,12,0.8,$60 NL Crazy Pineapple
3154,1/24/2023 5:00:00 pm,Horseshoe Las Vegas,89109,NLH,75,50,25,0.6666666666666666,No Limit Hold'em
3155,1/24/2023 5:00:00 pm,Bellagio Casino,89109,NLH,160,125,35,0.78125,No Limit Hold'em
3156,1/24/2023 6:00:00 pm,Caesars Palace,89109,NLH,100,75,25,0.75,No Limit Hold'em
3157,1/24/2023 6:05:00 pm,South Point Casino,89183,NLH,60,43,17,0.7166666666666667,No Limit Hold'em
3158,1/24/2023 6:10:00 pm,Venetian Casino,89109,NLH,300,250,50,0.8333333333333334,Deepstack Showdown Jan '23 - Event #31 - No Limit Hold'em Bounty
3159,1/24/2023 7:00:00 pm,MGM Grand,89109,NLH,100,75,25,0.75,No Limit Hold'em
3160,1/24/2023 7:05:00 pm,The Orleans Casino,89103,NLH,100,76,24,0.76,Super Stack No-Limit Hold'em
3161,1/24/2023 7:05:00 pm,Westgate Las Vegas Resort & Casino,89109,NLH,35,22,13,0.6285714285714286,**Tuesday $35 NLH
3162,1/24/2023 8:00:00 pm,Horseshoe Las Vegas,89109,NLH,75,50,25,0.6666666666666666,No Limit Hold'em
3163,1/24/2023 8:30:00 pm,Sahara Las Vegas,89109,NLH,60,48,12,0.8,$60 NLHE Daily
3164,1/24/2023 9:00:00 pm,Caesars Palace,89109,NLH,150,115,35,0.7666666666666667,No Limit Hold'em
3165,1/24/2023 10:05:00 pm,South Point Casino,89183,NLH,60,47,13,0.7833333333333333,No Limit Hold'em Turbo
3166,1/24/2023 11:00:00 pm,Horseshoe Las Vegas,89109,NLH,75,50,25,0.6666666666666666,No Limit Hold'em
3167,1/24/2023 11:59:00 pm,MGM Grand,89109,NLH,100,75,25,0.75,Midnight Maddness Hyper Turbo
3168,1/25/2023 12:00:00 am,Caesars Palace,89109,NLH,100,75,25,0.75,No Limit Hold'em
3169,1/25/2023 9:00:00 am,Horseshoe Las Vegas,89109,NLH,75,50,25,0.6666666666666666,No Limit Hold'em
3170,1/25/2023 10:00:00 am,Caesars Palace,89109,NLH,100,75,25,0.75,No Limit Hold'em
3171,1/25/2023 10:05:00 am,South Point Casino,89183,NLH,60,43,17,0.7166666666666667,No Limit Hold'em
3172,1/25/2023 11:00:00 am,Horseshoe Las Vegas,89109,NLH,75,50,25,0.6666666666666666,No Limit Hold'em
3173,1/25/2023 11:00:00 am,MGM Grand,89109,NLH,100,75,25,0.75,No Limit Hold'em
3174,1/25/2023 11:05:00 am,The Orleans Casino,89103,NLH,100,76,24,0.76,Super Stack No-Limit Hold'em
3175,1/25/2023 12:00:00 pm,Wynn Casino,89109,NLH,200,165,35,0.825,No Limit Hold'em
3176,1/25/2023 12:10:00 pm,Venetian Casino,89109,NLH,500,422,78,0.844,Deepstack Showdown Jan '23 - Event #32 - No Limit Hold'em EpicStack
3177,1/25/2023 12:10:00 pm,Sahara Las Vegas,89109,NLH,60,48,12,0.8,$60 NLHE Daily
3178,1/25/2023 1:00:00 pm,Aria Casino,89158,NLH,160,125,35,0.78125,No Limit Hold'em
3179,1/25/2023 2:00:00 pm,Horseshoe Las Vegas,89109,NLH,75,50,25,0.6666666666666666,No Limit Hold'em
3180,1/25/2023 2:00:00 pm,Caesars Palace,89109,NLH,150,115,35,0.7666666666666667,No Limit Hold'em
3181,1/25/2023 2:00:00 pm,MGM Grand,89109,NLH,100,75,25,0.75,No Limit Hold'em Turbo
3182,1/25/2023 2:05:00 pm,South Point Casino,89183,NLH,60,43,17,0.7166666666666667,No Limit Hold'em Turbo
3183,1/25/2023 4:00:00 pm,Sahara Las Vegas,89109,NLCRPI,60,48,12,0.8,$60 NL Crazy Pineapple
3184,1/25/2023 4:05:00 pm,The Orleans Casino,89103,O8/S8,150,118,32,0.7866666666666666,Omaha 8/B / Stud 8
3185,1/25/2023 5:00:00 pm,Horseshoe Las Vegas,89109,NLH,75,50,25,0.6666666666666666,No Limit Hold'em
3186,1/25/2023 5:00:00 pm,Bellagio Casino,89109,NLH,160,125,35,0.78125,No Limit Hold'em
3187,1/25/2023 6:00:00 pm,Caesars Palace,89109,NLH,100,75,25,0.75,No Limit Hold'em
3188,1/25/2023 6:05:00 pm,South Point Casino,89183,NLH,150,118,32,0.7866666666666666,No Limit Hold'em Deep Stack
3189,1/25/2023 6:10:00 pm,Venetian Casino,89109,NLH,300,250,50,0.8333333333333334,Deepstack Showdown Jan '23 - Event #33 - No Limit Hold'em Bounty Survivor
3190,1/25/2023 7:00:00 pm,MGM Grand,89109,NLH,100,75,25,0.75,No Limit Hold'em
3191,1/25/2023 7:05:00 pm,The Orleans Casino,89103,NLH,125,100,25,0.8,No Limit Hold'em Survivor
3192,1/25/2023 7:05:00 pm,Westgate Las Vegas Resort & Casino,89109,NLH,55,42,13,0.7636363636363637,**Wednesday $55 Bounty NLH
3193,1/25/2023 8:00:00 pm,Horseshoe Las Vegas,89109,NLH,75,50,25,0.6666666666666666,No Limit Hold'em
3194,1/25/2023 8:30:00 pm,Sahara Las Vegas,89109,NLH,60,48,12,0.8,*$60 NLHE Daily
3195,1/25/2023 9:00:00 pm,Caesars Palace,89109,NLH,150,115,35,0.7666666666666667,No Limit Hold'em
3196,1/25/2023 10:05:00 pm,South Point Casino,89183,NLH,60,47,13,0.7833333333333333,No Limit Hold'em Turbo
3197,1/25/2023 11:00:00 pm,Horseshoe Las Vegas,89109,NLH,75,50,25,0.6666666666666666,No Limit Hold'em
3198,1/25/2023 11:59:00 pm,MGM Grand,89109,NLH,100,75,25,0.75,Midnight Maddness Hyper Turbo
3199,1/26/2023 12:00:00 am,Caesars Palace,89109,NLH,100,75,25,0.75,No Limit Hold'em
3200,1/26/2023 9:00:00 am,Horseshoe Las Vegas,89109,NLH,75,50,25,0.6666666666666666,No Limit Hold'em
3201,1/26/2023 10:00:00 am,Caesars Palace,89109,NLH,100,75,25,0.75,No Limit Hold'em
3202,1/26/2023 10:05:00 am,South Point Casino,89183,NLH,60,43,17,0.7166666666666667,No Limit Hold'em
3203,1/26/2023 11:00:00 am,Horseshoe Las Vegas,89109,NLH,75,50,25,0.6666666666666666,No Limit Hold'em
3204,1/26/2023 11:00:00 am,MGM Grand,89109,NLH,100,75,25,0.75,No Limit Hold'em
3205,1/26/2023 11:05:00 am,The Orleans Casino,89103,NLH,100,76,24,0.76,Super Stack No-Limit Hold'em
3206,1/26/2023 11:10:00 am,Venetian Casino,89109,NLH,600,505,95,0.8416666666666667,Deepstack Showdown Jan '23 - Event #34 - No Limit Hold'em UltimateStack
3207,1/26/2023 12:00:00 pm,Wynn Casino,89109,NLH,200,165,35,0.825,No Limit Hold'em
3208,1/26/2023 12:10:00 pm,Sahara Las Vegas,89109,NLH,60,48,12,0.8,$60 NLHE Daily
3209,1/26/2023 1:00:00 pm,Aria Casino,89158,NLH,160,125,35,0.78125,No Limit Hold'em
3210,1/26/2023 2:00:00 pm,Horseshoe Las Vegas,89109,NLH,75,50,25,0.6666666666666666,No Limit Hold'em
3211,1/26/2023 2:00:00 pm,Caesars Palace,89109,NLH,150,115,35,0.7666666666666667,No Limit Hold'em
3212,1/26/2023 2:00:00 pm,MGM Grand,89109,NLH,100,75,25,0.75,No Limit Hold'em Turbo
3213,1/26/2023 2:00:00 pm,South Point Casino,89183,O8/S8,150,118,32,0.7866666666666666,Omaha 8 / Stud 8
3214,1/26/2023 4:00:00 pm,Sahara Las Vegas,89109,NLCRPI,60,48,12,0.8,$60 NL Crazy Pineapple
3215,1/26/2023 5:00:00 pm,Horseshoe Las Vegas,89109,NLH,75,50,25,0.6666666666666666,No Limit Hold'em
3216,1/26/2023 5:00:00 pm,Bellagio Casino,89109,NLH,160,125,35,0.78125,No Limit Hold'em
3217,1/26/2023 6:00:00 pm,Caesars Palace,89109,NLH,100,75,25,0.75,No Limit Hold'em
3218,1/26/2023 6:05:00 pm,South Point Casino,89183,NLH,60,43,17,0.7166666666666667,No Limit Hold'em
3219,1/26/2023 6:10:00 pm,Venetian Casino,89109,NLH,300,250,50,0.8333333333333334,Deepstack Showdown Jan '23 - Event #35 - No Limit Hold'em Bounty
3220,1/26/2023 7:00:00 pm,MGM Grand,89109,NLH,100,75,25,0.75,No Limit Hold'em
3221,1/26/2023 7:05:00 pm,The Orleans Casino,89103,NLH,100,76,24,0.76,Super Stack No-Limit Hold'em
3222,1/26/2023 7:05:00 pm,Westgate Las Vegas Resort & Casino,89109,NLH,60,45,15,0.75,**Thursday $60 No limit Crazy Pineapple
3223,1/26/2023 8:00:00 pm,Mandalay Bay,89119,NLH,60,40,20,0.6666666666666666,No Limit Hold'em
3224,1/26/2023 8:00:00 pm,Horseshoe Las Vegas,89109,NLH,75,50,25,0.6666666666666666,No Limit Hold'em
3225,1/26/2023 8:30:00 pm,Sahara Las Vegas,89109,NLH,60,48,12,0.8,$60 NLHE Daily
3226,1/26/2023 9:00:00 pm,Caesars Palace,89109,NLH,150,115,35,0.7666666666666667,No Limit Hold'em
3227,1/26/2023 10:05:00 pm,South Point Casino,89183,NLH,60,47,13,0.7833333333333333,No Limit Hold'em Turbo
3228,1/26/2023 11:00:00 pm,Horseshoe Las Vegas,89109,NLH,75,50,25,0.6666666666666666,No Limit Hold'em
3229,1/26/2023 11:59:00 pm,MGM Grand,89109,NLH,100,75,25,0.75,Midnight Maddness Hyper Turbo
3230,1/27/2023 12:00:00 am,Caesars Palace,89109,NLH,100,75,25,0.75,No Limit Hold'em
3231,1/27/2023 9:00:00 am,Horseshoe Las Vegas,89109,NLH,75,50,25,0.6666666666666666,No Limit Hold'em
3232,1/27/2023 10:00:00 am,Caesars Palace,89109,NLH,100,75,25,0.75,No Limit Hold'em
3233,1/27/2023 10:05:00 am,South Point Casino,89183,NLH,60,43,17,0.7166666666666667,No Limit Hold'em
3234,1/27/2023 11:00:00 am,Horseshoe Las Vegas,89109,NLH,75,50,25,0.6666666666666666,No Limit Hold'em
3235,1/27/2023 11:00:00 am,MGM Grand,89109,NLH,100,75,25,0.75,No Limit Hold'em
3236,1/27/2023 11:00:00 am,Wynn Casino,89109,NLH,230,190,40,0.8260869565217391,No Limit Hold'em
3237,1/27/2023 11:05:00 am,The Orleans Casino,89103,NLH,100,76,24,0.76,Super Stack No-Limit Hold'em
3238,1/27/2023 11:10:00 am,Venetian Casino,89109,NLH,600,505,95,0.8416666666666667,Deepstack Showdown Jan '23 - Event #34 - No Limit Hold'em UltimateStack
3239,1/27/2023 12:10:00 pm,Sahara Las Vegas,89109,NLH,60,48,12,0.8,$60 NLHE Daily
3240,1/27/2023 1:00:00 pm,Aria Casino,89158,NLH,240,195,45,0.8125,No Limit Hold'em
3241,1/27/2023 2:00:00 pm,Horseshoe Las Vegas,89109,NLH,75,50,25,0.6666666666666666,No Limit Hold'em
3242,1/27/2023 2:00:00 pm,Caesars Palace,89109,NLH,150,115,35,0.7666666666666667,No Limit Hold'em
3243,1/27/2023 2:00:00 pm,MGM Grand,89109,NLH,100,75,25,0.75,No Limit Hold'em Turbo
3244,1/27/2023 2:05:00 pm,South Point Casino,89183,NLH,60,43,17,0.7166666666666667,No Limit Hold'em Turbo
3245,1/27/2023 4:00:00 pm,Sahara Las Vegas,89109,NLCRPI,60,48,12,0.8,$60 NL Crazy Pineapple
3246,1/27/2023 5:00:00 pm,Horseshoe Las Vegas,89109,NLH,75,50,25,0.6666666666666666,No Limit Hold'em
3247,1/27/2023 6:00:00 pm,Caesars Palace,89109,NLH,100,75,25,0.75,No Limit Hold'em
3248,1/27/2023 6:00:00 pm,South Point Casino,89183,NLH,150,118,32,0.7866666666666666,No Limit Hold'em Double Green Chip Bounty
3249,1/27/2023 6:10:00 pm,Venetian Casino,89109,NLH,300,250,50,0.8333333333333334,Deepstack Showdown Jan '23 - Event #36 - No Limit Hold'em Bounty
3250,1/27/2023 6:30:00 pm,Poker Palace Casino,89030,NLH,20,10,10,0.5,No Limit Hold'em
3251,1/27/2023 7:00:00 pm,MGM Grand,89109,NLH,100,75,25,0.75,No Limit Hold'em
3252,1/27/2023 7:05:00 pm,The Orleans Casino,89103,NLH,150,118,32,0.7866666666666666,No-Limit Hold'em
3253,1/27/2023 7:05:00 pm,Westgate Las Vegas Resort & Casino,89109,NLH,35,22,13,0.6285714285714286,**Friday $35 NLH w/add-on
3254,1/27/2023 8:00:00 pm,Mandalay Bay,89119,NLH,60,40,20,0.6666666666666666,No Limit Hold'em
3255,1/27/2023 8:00:00 pm,Horseshoe Las Vegas,89109,NLH,75,50,25,0.6666666666666666,No Limit Hold'em
3256,1/27/2023 8:30:00 pm,Sahara Las Vegas,89109,NLH,60,48,12,0.8,$60 NLHE Daily
3257,1/27/2023 9:00:00 pm,Caesars Palace,89109,NLH,150,115,35,0.7666666666666667,No Limit Hold'em
3258,1/27/2023 10:05:00 pm,South Point Casino,89183,NLH,60,47,13,0.7833333333333333,No Limit Hold'em Turbo
3259,1/27/2023 11:00:00 pm,Horseshoe Las Vegas,89109,NLH,75,50,25,0.6666666666666666,No Limit Hold'em
3260,1/27/2023 11:59:00 pm,MGM Grand,89109,NLH,100,75,25,0.75,Midnight Maddness Hyper Turbo
3261,1/28/2023 12:00:00 am,Caesars Palace,89109,NLH,100,75,25,0.75,No Limit Hold'em
3262,1/28/2023 9:00:00 am,Horseshoe Las Vegas,89109,NLH,75,50,25,0.6666666666666666,No Limit Hold'em
3263,1/28/2023 10:00:00 am,Caesars Palace,89109,NLH,100,75,25,0.75,No Limit Hold'em
3264,1/28/2023 10:05:00 am,South Point Casino,89183,NLH,60,43,17,0.7166666666666667,No Limit Hold'em
3265,1/28/2023 11:00:00 am,Horseshoe Las Vegas,89109,NLH,75,50,25,0.6666666666666666,No Limit Hold'em
3266,1/28/2023 11:00:00 am,MGM Grand,89109,NLH,100,75,25,0.75,No Limit Hold'em
3267,1/28/2023 11:00:00 am,Wynn Casino,89109,NLH,300,256,44,0.8533333333333334,No Limit Hold'em
3268,1/28/2023 11:05:00 am,The Orleans Casino,89103,NLH,150,118,32,0.7866666666666666,No-Limit Hold'em Monster Stack
3269,1/28/2023 11:10:00 am,Venetian Casino,89109,NLH,600,505,95,0.8416666666666667,Deepstack Showdown Jan '23 - Event #34 - No Limit Hold'em UltimateStack
3270,1/28/2023 12:05:00 pm,Westgate Las Vegas Resort & Casino,89109,NLH,35,22,13,0.6285714285714286,*Saturday $35 NLH w/add-on
3271,1/28/2023 12:10:00 pm,Sahara Las Vegas,89109,NLH,60,48,12,0.8,$60 NLHE Daily
3272,1/28/2023 1:00:00 pm,Aria Casino,89158,NLH,240,195,45,0.8125,No Limit Hold'em
3273,1/28/2023 2:00:00 pm,Caesars Palace,89109,NLH,150,115,35,0.7666666666666667,No Limit Hold'em
3274,1/28/2023 2:00:00 pm,Horseshoe Las Vegas,89109,NLH,160,115,45,0.71875,No Limit Hold'em Saturday
3275,1/28/2023 2:00:00 pm,MGM Grand,89109,NLH,100,75,25,0.75,No Limit Hold'em Turbo
3276,1/28/2023 2:05:00 pm,South Point Casino,89183,NLH,60,43,17,0.7166666666666667,No Limit Hold'em Turbo
3277,1/28/2023 4:00:00 pm,MGM Grand,89109,PLO,150,120,30,0.8,Double Board Bomb Pot PLO
3278,1/28/2023 4:00:00 pm,Sahara Las Vegas,89109,NLCRPI,60,48,12,0.8,$60 NL Crazy Pineapple
3279,1/28/2023 5:00:00 pm,Horseshoe Las Vegas,89109,NLH,75,50,25,0.6666666666666666,No Limit Hold'em
3280,1/28/2023 6:00:00 pm,Caesars Palace,89109,NLH,100,75,25,0.75,No Limit Hold'em
3281,1/28/2023 6:05:00 pm,South Point Casino,89183,NLH,150,118,32,0.7866666666666666,No Limit Hold'em Deep Stack
3282,1/28/2023 6:30:00 pm,Poker Palace Casino,89030,NLH,20,10,10,0.5,No Limit Hold'em
3283,1/28/2023 7:00:00 pm,MGM Grand,89109,NLH,100,75,25,0.75,No Limit Hold'em
3284,1/28/2023 7:05:00 pm,The Orleans Casino,89103,NLH,220,188,32,0.8545454545454545,No Limit Hold'em Bounty
3285,1/28/2023 7:05:00 pm,Westgate Las Vegas Resort & Casino,89109,NLH,35,22,13,0.6285714285714286,*Saturday $35 NLH w/add-on
3286,1/28/2023 8:00:00 pm,Horseshoe Las Vegas,89109,NLH,75,50,25,0.6666666666666666,No Limit Hold'em
3287,1/28/2023 8:00:00 pm,Mandalay Bay,89119,NLH,150,125,25,0.8333333333333334,No Limit Hold'em Saturday Night Classic
3288,1/28/2023 8:30:00 pm,Sahara Las Vegas,89109,NLH,60,48,12,0.8,$60 NLHE Daily
3289,1/28/2023 9:00:00 pm,Caesars Palace,89109,NLH,150,115,35,0.7666666666666667,No Limit Hold'em
3290,1/28/2023 10:05:00 pm,South Point Casino,89183,NLH,60,47,13,0.7833333333333333,No Limit Hold'em Turbo
3291,1/28/2023 11:00:00 pm,Horseshoe Las Vegas,89109,NLH,75,50,25,0.6666666666666666,No Limit Hold'em
3292,1/28/2023 11:59:00 pm,MGM Grand,89109,NLH,100,75,25,0.75,Midnight Maddness Hyper Turbo
3293,1/29/2023 12:00:00 am,Caesars Palace,89109,NLH,100,75,25,0.75,No Limit Hold'em
3294,1/29/2023 9:00:00 am,Horseshoe Las Vegas,89109,NLH,75,50,25,0.6666666666666666,No Limit Hold'em
3295,1/29/2023 10:00:00 am,Caesars Palace,89109,NLH,100,75,25,0.75,No Limit Hold'em
3296,1/29/2023 10:05:00 am,South Point Casino,89183,NLH,60,43,17,0.7166666666666667,No Limit Hold'em
3297,1/29/2023 11:00:00 am,Horseshoe Las Vegas,89109,NLH,75,50,25,0.6666666666666666,No Limit Hold'em
3298,1/29/2023 11:00:00 am,MGM Grand,89109,NLH,100,75,25,0.75,No Limit Hold'em
3299,1/29/2023 11:05:00 am,The Orleans Casino,89103,NLH,200,148,52,0.74,Sunday Special No-Limit Hold'em
3300,1/29/2023 12:00:00 pm,Wynn Casino,89109,NLH,200,165,35,0.825,No Limit Hold'em
3301,1/29/2023 12:05:00 pm,Westgate Las Vegas Resort & Casino,89109,NLH,35,22,13,0.6285714285714286,*Sunday $35 NLH w/add-on
3302,1/29/2023 12:10:00 pm,Venetian Casino,89109,NLH,500,422,78,0.844,Deepstack Showdown Jan '23 - Event #37 - No Limit Hold'em EpicStack Freezeout
3303,1/29/2023 1:00:00 pm,Aria Casino,89158,NLH,160,125,35,0.78125,No Limit Hold'em
3304,1/29/2023 1:10:00 pm,Sahara Las Vegas,89109,NLH,75,65,10,0.8666666666666667,$75 NLHE Bounty
3305,1/29/2023 2:00:00 pm,Horseshoe Las Vegas,89109,NLH,75,50,25,0.6666666666666666,No Limit Hold'em
3306,1/29/2023 2:00:00 pm,Caesars Palace,89109,NLH,150,115,35,0.7666666666666667,No Limit Hold'em
3307,1/29/2023 2:00:00 pm,MGM Grand,89109,NLH,100,75,25,0.75,No Limit Hold'em Turbo
3308,1/29/2023 4:05:00 pm,The Orleans Casino,89103,ROSE,200,158,42,0.79,R.O.S.E.
3309,1/29/2023 5:00:00 pm,Horseshoe Las Vegas,89109,NLH,75,50,25,0.6666666666666666,No Limit Hold'em
3310,1/29/2023 5:00:00 pm,Bellagio Casino,89109,NLH,160,125,35,0.78125,No Limit Hold'em
3311,1/29/2023 5:20:00 pm,Sahara Las Vegas,89109,NLCRPI,75,60,15,0.8,$75 Primetime Splash Pot Pineapple
3312,1/29/2023 6:00:00 pm,Caesars Palace,89109,NLH,100,75,25,0.75,No Limit Hold'em
3313,1/29/2023 6:05:00 pm,South Point Casino,89183,NLH,150,118,32,0.7866666666666666,No Limit Hold'em Deep Stack
3314,1/29/2023 6:10:00 pm,Venetian Casino,89109,NLH,300,250,50,0.8333333333333334,Deepstack Showdown Jan '23 - Event #38 - No Limit Hold'em Bounty
3315,1/29/2023 7:00:00 pm,MGM Grand,89109,NLH,100,75,25,0.75,No Limit Hold'em
3316,1/29/2023 7:05:00 pm,Westgate Las Vegas Resort & Casino,89109,NLH,35,22,13,0.6285714285714286,*Sunday $35 NLH w/add-on
3317,1/29/2023 8:00:00 pm,Mandalay Bay,89119,NLH,60,40,20,0.6666666666666666,No Limit Hold'em
3318,1/29/2023 8:00:00 pm,Horseshoe Las Vegas,89109,NLH,75,50,25,0.6666666666666666,No Limit Hold'em
3319,1/29/2023 9:00:00 pm,Caesars Palace,89109,NLH,150,115,35,0.7666666666666667,No Limit Hold'em
3320,1/29/2023 9:30:00 pm,Sahara Las Vegas,89109,NLH,60,48,12,0.8,$60 NLHE Daily
3321,1/29/2023 10:05:00 pm,South Point Casino,89183,NLH,60,47,13,0.7833333333333333,No Limit Hold'em Turbo
3322,1/29/2023 11:00:00 pm,Horseshoe Las Vegas,89109,NLH,75,50,25,0.6666666666666666,No Limit Hold'em
3323,1/29/2023 11:59:00 pm,MGM Grand,89109,NLH,100,75,25,0.75,Midnight Maddness Hyper Turbo
3324,1/30/2023 12:00:00 am,Caesars Palace,89109,NLH,100,75,25,0.75,No Limit Hold'em
3325,1/30/2023 9:00:00 am,Horseshoe Las Vegas,89109,NLH,75,50,25,0.6666666666666666,No Limit Hold'em
3326,1/30/2023 10:00:00 am,Caesars Palace,89109,NLH,100,75,25,0.75,No Limit Hold'em
3327,1/30/2023 10:05:00 am,South Point Casino,89183,NLH,60,43,17,0.7166666666666667,No Limit Hold'em
3328,1/30/2023 11:00:00 am,Horseshoe Las Vegas,89109,NLH,75,50,25,0.6666666666666666,No Limit Hold'em
3329,1/30/2023 11:00:00 am,MGM Grand,89109,NLH,100,75,25,0.75,No Limit Hold'em
3330,1/30/2023 11:05:00 am,The Orleans Casino,89103,NLH,100,76,24,0.76,Super Stack No-Limit Hold'em
3331,1/30/2023 11:10:00 am,Venetian Casino,89109,NLH,400,330,70,0.825,Deepstack Showdown Jan '23 - Event #39 - No Limit Hold'em UltimateStack
3332,1/30/2023 12:00:00 pm,Wynn Casino,89109,NLH,200,165,35,0.825,No Limit Hold'em
3333,1/30/2023 12:10:00 pm,Sahara Las Vegas,89109,NLH,60,48,12,0.8,$60 NLHE Daily
3334,1/30/2023 1:00:00 pm,Aria Casino,89158,NLH,160,125,35,0.78125,No Limit Hold'em
3335,1/30/2023 2:00:00 pm,Horseshoe Las Vegas,89109,NLH,75,50,25,0.6666666666666666,No Limit Hold'em
3336,1/30/2023 2:00:00 pm,Caesars Palace,89109,NLH,150,115,35,0.7666666666666667,No Limit Hold'em
3337,1/30/2023 2:00:00 pm,MGM Grand,89109,NLH,100,75,25,0.75,No Limit Hold'em Turbo
3338,1/30/2023 2:05:00 pm,South Point Casino,89183,NLH,60,43,17,0.7166666666666667,No Limit Hold'em Turbo
3339,1/30/2023 4:00:00 pm,Sahara Las Vegas,89109,NLCRPI,60,48,12,0.8,$60 NL Crazy Pineapple
3340,1/30/2023 4:05:00 pm,The Orleans Casino,89103,HORSE,125,98,27,0.784,H.O.R.S.E.
3341,1/30/2023 5:00:00 pm,Horseshoe Las Vegas,89109,NLH,75,50,25,0.6666666666666666,No Limit Hold'em
3342,1/30/2023 5:00:00 pm,Bellagio Casino,89109,NLH,160,125,35,0.78125,No Limit Hold'em
3343,1/30/2023 6:00:00 pm,Caesars Palace,89109,NLH,100,75,25,0.75,No Limit Hold'em
3344,1/30/2023 6:05:00 pm,South Point Casino,89183,NLH,60,43,17,0.7166666666666667,No Limit Hold'em
3345,1/30/2023 6:10:00 pm,Venetian Casino,89109,NLH,300,250,50,0.8333333333333334,Deepstack Showdown Jan '23 - Event #40 - No Limit Hold'em Bounty
3346,1/30/2023 7:00:00 pm,MGM Grand,89109,NLH,100,75,25,0.75,No Limit Hold'em
3347,1/30/2023 7:05:00 pm,The Orleans Casino,89103,NLH,125,98,27,0.784,No Limit Crazy Pineapple
3348,1/30/2023 7:05:00 pm,Westgate Las Vegas Resort & Casino,89109,NLH,55,42,13,0.7636363636363637,Monday $55 Bounty NLH
3349,1/30/2023 8:00:00 pm,Mandalay Bay,89119,NLH,60,40,20,0.6666666666666666,No Limit Hold'em
3350,1/30/2023 8:00:00 pm,Horseshoe Las Vegas,89109,NLH,75,50,25,0.6666666666666666,No Limit Hold'em
3351,1/30/2023 8:30:00 pm,Sahara Las Vegas,89109,NLH,60,48,12,0.8,$60 NLHE Daily
3352,1/30/2023 9:00:00 pm,Caesars Palace,89109,NLH,150,115,35,0.7666666666666667,No Limit Hold'em
3353,1/30/2023 10:05:00 pm,South Point Casino,89183,NLH,60,47,13,0.7833333333333333,No Limit Hold'em Turbo
3354,1/30/2023 11:00:00 pm,Horseshoe Las Vegas,89109,NLH,75,50,25,0.6666666666666666,No Limit Hold'em
3355,1/30/2023 11:59:00 pm,MGM Grand,89109,NLH,100,75,25,0.75,Midnight Maddness Hyper Turbo
3356,1/31/2023 12:00:00 am,Caesars Palace,89109,NLH,100,75,25,0.75,No Limit Hold'em
3357,1/31/2023 9:00:00 am,Horseshoe Las Vegas,89109,NLH,75,50,25,0.6666666666666666,No Limit Hold'em
3358,1/31/2023 10:00:00 am,Caesars Palace,89109,NLH,100,75,25,0.75,No Limit Hold'em
3359,1/31/2023 10:05:00 am,South Point Casino,89183,NLH,60,43,17,0.7166666666666667,No Limit Hold'em
3360,1/31/2023 11:00:00 am,Horseshoe Las Vegas,89109,NLH,75,50,25,0.6666666666666666,No Limit Hold'em
3361,1/31/2023 11:05:00 am,The Orleans Casino,89103,NLH,100,76,24,0.76,Super Stack No-Limit Hold'em
3362,1/31/2023 11:10:00 am,Venetian Casino,89109,NLH,400,330,70,0.825,Deepstack Showdown Jan '23 - Event #39 - No Limit Hold'em UltimateStack
3363,1/31/2023 12:00:00 pm,Wynn Casino,89109,NLH,200,165,35,0.825,No Limit Hold'em
3364,1/31/2023 12:10:00 pm,Sahara Las Vegas,89109,NLH,60,48,12,0.8,$60 NLHE Daily
3365,1/31/2023 1:00:00 pm,Aria Casino,89158,NLH,160,125,35,0.78125,No Limit Hold'em
3366,1/31/2023 2:00:00 pm,Horseshoe Las Vegas,89109,NLH,75,50,25,0.6666666666666666,No Limit Hold'em
3367,1/31/2023 2:00:00 pm,Caesars Palace,89109,NLH,150,115,35,0.7666666666666667,No Limit Hold'em
3368,1/31/2023 2:05:00 pm,South Point Casino,89183,FLO8,60,43,17,0.7166666666666667,Omaha 8/B
3369,1/31/2023 4:00:00 pm,Sahara Las Vegas,89109,NLCRPI,60,48,12,0.8,$60 NL Crazy Pineapple
3370,1/31/2023 5:00:00 pm,Horseshoe Las Vegas,89109,NLH,75,50,25,0.6666666666666666,No Limit Hold'em
3371,1/31/2023 5:00:00 pm,Bellagio Casino,89109,NLH,160,125,35,0.78125,No Limit Hold'em
3372,1/31/2023 6:00:00 pm,Caesars Palace,89109,NLH,100,75,25,0.75,No Limit Hold'em
3373,1/31/2023 6:05:00 pm,South Point Casino,89183,NLH,60,43,17,0.7166666666666667,No Limit Hold'em
3374,1/31/2023 6:10:00 pm,Venetian Casino,89109,NLH,300,250,50,0.8333333333333334,Deepstack Showdown Jan '23 - Event #41 - No Limit Hold'em Bounty
3375,1/31/2023 7:05:00 pm,The Orleans Casino,89103,NLH,100,76,24,0.76,Super Stack No-Limit Hold'em
3376,1/31/2023 7:05:00 pm,Westgate Las Vegas Resort & Casino,89109,NLH,35,22,13,0.6285714285714286,Tuesday $35 NLH
3377,1/31/2023 8:00:00 pm,Horseshoe Las Vegas,89109,NLH,75,50,25,0.6666666666666666,No Limit Hold'em
3378,1/31/2023 8:30:00 pm,Sahara Las Vegas,89109,NLH,60,48,12,0.8,$60 NLHE Daily
3379,1/31/2023 9:00:00 pm,Caesars Palace,89109,NLH,150,115,35,0.7666666666666667,No Limit Hold'em
3380,1/31/2023 10:05:00 pm,South Point Casino,89183,NLH,60,47,13,0.7833333333333333,No Limit Hold'em Turbo
3381,1/31/2023 11:00:00 pm,Horseshoe Las Vegas,89109,NLH,75,50,25,0.6666666666666666,No Limit Hold'em
3382,1/31/2023 11:59:00 pm,MGM Grand,89109,NLH,100,75,25,0.75,Midnight Maddness Hyper Turbo
3383,2/01/2023 12:00:00 am,Caesars Palace,89109,NLH,100,75,25,0.75,No Limit Hold'em
3384,2/01/2023 9:00:00 am,Horseshoe Las Vegas,89109,NLH,75,50,25,0.6666666666666666,No Limit Hold'em
3385,2/01/2023 10:00:00 am,Caesars Palace,89109,NLH,100,75,25,0.75,No Limit Hold'em
3386,2/01/2023 10:05:00 am,South Point Casino,89183,NLH,60,43,17,0.7166666666666667,No Limit Hold'em
3387,2/01/2023 11:00:00 am,Horseshoe Las Vegas,89109,NLH,75,50,25,0.6666666666666666,No Limit Hold'em
3388,2/01/2023 11:05:00 am,The Orleans Casino,89103,NLH,100,76,24,0.76,Super Stack No-Limit Hold'em
3389,2/01/2023 12:00:00 pm,Wynn Casino,89109,NLH,200,165,35,0.825,No Limit Hold'em
3390,2/01/2023 12:10:00 pm,Venetian Casino,89109,NLH,500,422,78,0.844,Deepstack Showdown Jan '23 - Event #42 - No Limit Hold'em EpicStack Freezeout
3391,2/01/2023 12:10:00 pm,Sahara Las Vegas,89109,NLH,60,48,12,0.8,$60 NLHE Daily
3392,2/01/2023 1:00:00 pm,Aria Casino,89158,NLH,160,125,35,0.78125,No Limit Hold'em
3393,2/01/2023 2:00:00 pm,Horseshoe Las Vegas,89109,NLH,75,50,25,0.6666666666666666,No Limit Hold'em
3394,2/01/2023 2:00:00 pm,Caesars Palace,89109,NLH,150,115,35,0.7666666666666667,No Limit Hold'em
3395,2/01/2023 2:05:00 pm,South Point Casino,89183,NLH,60,43,17,0.7166666666666667,No Limit Hold'em Turbo
3396,2/01/2023 4:00:00 pm,Sahara Las Vegas,89109,NLCRPI,60,48,12,0.8,$60 NL Crazy Pineapple
3397,2/01/2023 4:05:00 pm,The Orleans Casino,89103,O8/S8,150,118,32,0.7866666666666666,Omaha 8/B / Stud 8
3398,2/01/2023 5:00:00 pm,Horseshoe Las Vegas,89109,NLH,75,50,25,0.6666666666666666,No Limit Hold'em
3399,2/01/2023 5:00:00 pm,Bellagio Casino,89109,NLH,160,125,35,0.78125,No Limit Hold'em
3400,2/01/2023 6:00:00 pm,Caesars Palace,89109,NLH,100,75,25,0.75,No Limit Hold'em
3401,2/01/2023 6:05:00 pm,South Point Casino,89183,NLH,150,118,32,0.7866666666666666,No Limit Hold'em Deep Stack
3402,2/01/2023 6:10:00 pm,Venetian Casino,89109,NLH,300,250,50,0.8333333333333334,Deepstack Showdown Jan '23 - Event #43 - No Limit Hold'em Bounty Survivor
3403,2/01/2023 7:05:00 pm,The Orleans Casino,89103,NLH,125,100,25,0.8,No Limit Hold'em Survivor
3404,2/01/2023 8:00:00 pm,Horseshoe Las Vegas,89109,NLH,75,50,25,0.6666666666666666,No Limit Hold'em
3405,2/01/2023 8:30:00 pm,Sahara Las Vegas,89109,NLH,60,48,12,0.8,*$60 NLHE Daily
3406,2/01/2023 9:00:00 pm,Caesars Palace,89109,NLH,150,115,35,0.7666666666666667,No Limit Hold'em
3407,2/01/2023 10:05:00 pm,South Point Casino,89183,NLH,60,47,13,0.7833333333333333,No Limit Hold'em Turbo
3408,2/01/2023 11:00:00 pm,Horseshoe Las Vegas,89109,NLH,75,50,25,0.6666666666666666,No Limit Hold'em
3409,2/01/2023 11:59:00 pm,MGM Grand,89109,NLH,100,75,25,0.75,Midnight Maddness Hyper Turbo
3410,2/02/2023 12:00:00 am,Caesars Palace,89109,NLH,100,75,25,0.75,No Limit Hold'em
3411,2/02/2023 9:00:00 am,Horseshoe Las Vegas,89109,NLH,75,50,25,0.6666666666666666,No Limit Hold'em
3412,2/02/2023 10:00:00 am,Caesars Palace,89109,NLH,100,75,25,0.75,No Limit Hold'em
3413,2/02/2023 10:05:00 am,South Point Casino,89183,NLH,60,43,17,0.7166666666666667,No Limit Hold'em
3414,2/02/2023 11:00:00 am,Horseshoe Las Vegas,89109,NLH,75,50,25,0.6666666666666666,No Limit Hold'em
3415,2/02/2023 11:00:00 am,MGM Grand,89109,NLH,100,75,25,0.75,No Limit Hold'em
3416,2/02/2023 11:05:00 am,The Orleans Casino,89103,NLH,100,76,24,0.76,Super Stack No-Limit Hold'em
3417,2/02/2023 11:10:00 am,Venetian Casino,89109,NLH,800,690,110,0.8625,Deepstack Showdown Jan '23 - Event #44 - No Limit Hold'em UltimateStack
3418,2/02/2023 12:00:00 pm,Wynn Casino,89109,NLH,200,165,35,0.825,No Limit Hold'em
3419,2/02/2023 12:10:00 pm,Sahara Las Vegas,89109,NLH,60,48,12,0.8,$60 NLHE Daily
3420,2/02/2023 1:00:00 pm,Aria Casino,89158,NLH,160,125,35,0.78125,No Limit Hold'em
3421,2/02/2023 2:00:00 pm,Horseshoe Las Vegas,89109,NLH,75,50,25,0.6666666666666666,No Limit Hold'em
3422,2/02/2023 2:00:00 pm,Caesars Palace,89109,NLH,150,115,35,0.7666666666666667,No Limit Hold'em
3423,2/02/2023 2:00:00 pm,MGM Grand,89109,NLH,100,75,25,0.75,No Limit Hold'em Turbo
3424,2/02/2023 2:00:00 pm,South Point Casino,89183,O8/S8,150,118,32,0.7866666666666666,Omaha 8 / Stud 8
3425,2/02/2023 4:00:00 pm,Sahara Las Vegas,89109,NLCRPI,60,48,12,0.8,$60 NL Crazy Pineapple
3426,2/02/2023 5:00:00 pm,Horseshoe Las Vegas,89109,NLH,75,50,25,0.6666666666666666,No Limit Hold'em
3427,2/02/2023 5:00:00 pm,Bellagio Casino,89109,NLH,160,125,35,0.78125,No Limit Hold'em
3428,2/02/2023 6:00:00 pm,Caesars Palace,89109,NLH,100,75,25,0.75,No Limit Hold'em
3429,2/02/2023 6:05:00 pm,South Point Casino,89183,NLH,60,43,17,0.7166666666666667,No Limit Hold'em
3430,2/02/2023 6:10:00 pm,Venetian Casino,89109,NLH,300,250,50,0.8333333333333334,Deepstack Showdown Jan '23 - Event #45 - No Limit Hold'em Survivor
3431,2/02/2023 7:00:00 pm,MGM Grand,89109,NLH,100,75,25,0.75,No Limit Hold'em
3432,2/02/2023 7:05:00 pm,The Orleans Casino,89103,NLH,100,76,24,0.76,Super Stack No-Limit Hold'em
3433,2/02/2023 8:00:00 pm,Mandalay Bay,89119,NLH,60,40,20,0.6666666666666666,No Limit Hold'em
3434,2/02/2023 8:00:00 pm,Horseshoe Las Vegas,89109,NLH,75,50,25,0.6666666666666666,No Limit Hold'em
3435,2/02/2023 8:30:00 pm,Sahara Las Vegas,89109,NLH,60,48,12,0.8,$60 NLHE Daily
3436,2/02/2023 9:00:00 pm,Caesars Palace,89109,NLH,150,115,35,0.7666666666666667,No Limit Hold'em
3437,2/02/2023 10:05:00 pm,South Point Casino,89183,NLH,60,47,13,0.7833333333333333,No Limit Hold'em Turbo
3438,2/02/2023 11:00:00 pm,Horseshoe Las Vegas,89109,NLH,75,50,25,0.6666666666666666,No Limit Hold'em
3439,2/02/2023 11:59:00 pm,MGM Grand,89109,NLH,100,75,25,0.75,Midnight Maddness Hyper Turbo
3440,2/03/2023 12:00:00 am,Caesars Palace,89109,NLH,100,75,25,0.75,No Limit Hold'em
3441,2/03/2023 9:00:00 am,Horseshoe Las Vegas,89109,NLH,75,50,25,0.6666666666666666,No Limit Hold'em
3442,2/03/2023 10:00:00 am,Caesars Palace,89109,NLH,100,75,25,0.75,No Limit Hold'em
3443,2/03/2023 10:05:00 am,South Point Casino,89183,NLH,60,43,17,0.7166666666666667,No Limit Hold'em
3444,2/03/2023 11:00:00 am,Horseshoe Las Vegas,89109,NLH,75,50,25,0.6666666666666666,No Limit Hold'em
3445,2/03/2023 11:00:00 am,MGM Grand,89109,NLH,100,75,25,0.75,No Limit Hold'em
3446,2/03/2023 11:00:00 am,Wynn Casino,89109,NLH,230,190,40,0.8260869565217391,No Limit Hold'em
3447,2/03/2023 11:05:00 am,The Orleans Casino,89103,NLH,100,76,24,0.76,Super Stack No-Limit Hold'em
3448,2/03/2023 11:10:00 am,Venetian Casino,89109,NLH,800,690,110,0.8625,Deepstack Showdown Jan '23 - Event #44 - No Limit Hold'em UltimateStack
3449,2/03/2023 12:10:00 pm,Sahara Las Vegas,89109,NLH,60,48,12,0.8,$60 NLHE Daily
3450,2/03/2023 1:00:00 pm,Aria Casino,89158,NLH,240,195,45,0.8125,No Limit Hold'em
3451,2/03/2023 2:00:00 pm,Horseshoe Las Vegas,89109,NLH,75,50,25,0.6666666666666666,No Limit Hold'em
3452,2/03/2023 2:00:00 pm,Caesars Palace,89109,NLH,150,115,35,0.7666666666666667,No Limit Hold'em
3453,2/03/2023 2:00:00 pm,MGM Grand,89109,NLH,100,75,25,0.75,No Limit Hold'em Turbo
3454,2/03/2023 2:05:00 pm,South Point Casino,89183,NLH,60,43,17,0.7166666666666667,No Limit Hold'em Turbo
3455,2/03/2023 4:00:00 pm,Sahara Las Vegas,89109,NLCRPI,60,48,12,0.8,$60 NL Crazy Pineapple
3456,2/03/2023 5:00:00 pm,Horseshoe Las Vegas,89109,NLH,75,50,25,0.6666666666666666,No Limit Hold'em
3457,2/03/2023 6:00:00 pm,Caesars Palace,89109,NLH,100,75,25,0.75,No Limit Hold'em
3458,2/03/2023 6:00:00 pm,South Point Casino,89183,NLH,150,118,32,0.7866666666666666,No Limit Hold'em Double Green Chip Bounty
3459,2/03/2023 6:10:00 pm,Venetian Casino,89109,NLH,300,250,50,0.8333333333333334,Deepstack Showdown Jan '23 - Event #46 - No Limit Hold'em Survivor
3460,2/03/2023 6:30:00 pm,Poker Palace Casino,89030,NLH,20,10,10,0.5,No Limit Hold'em
3461,2/03/2023 7:00:00 pm,MGM Grand,89109,NLH,100,75,25,0.75,No Limit Hold'em
3462,2/03/2023 7:05:00 pm,The Orleans Casino,89103,NLH,150,118,32,0.7866666666666666,No-Limit Hold'em
3463,2/03/2023 8:00:00 pm,Mandalay Bay,89119,NLH,60,40,20,0.6666666666666666,No Limit Hold'em
3464,2/03/2023 8:00:00 pm,Horseshoe Las Vegas,89109,NLH,75,50,25,0.6666666666666666,No Limit Hold'em
3465,2/03/2023 8:30:00 pm,Sahara Las Vegas,89109,NLH,60,48,12,0.8,$60 NLHE Daily
3466,2/03/2023 9:00:00 pm,Caesars Palace,89109,NLH,150,115,35,0.7666666666666667,No Limit Hold'em
3467,2/03/2023 10:05:00 pm,South Point Casino,89183,NLH,60,47,13,0.7833333333333333,No Limit Hold'em Turbo
3468,2/03/2023 11:00:00 pm,Horseshoe Las Vegas,89109,NLH,75,50,25,0.6666666666666666,No Limit Hold'em
3469,2/03/2023 11:59:00 pm,MGM Grand,89109,NLH,100,75,25,0.75,Midnight Maddness Hyper Turbo
3470,2/04/2023 12:00:00 am,Caesars Palace,89109,NLH,100,75,25,0.75,No Limit Hold'em
3471,2/04/2023 9:00:00 am,Horseshoe Las Vegas,89109,NLH,75,50,25,0.6666666666666666,No Limit Hold'em
3472,2/04/2023 10:00:00 am,Caesars Palace,89109,NLH,100,75,25,0.75,No Limit Hold'em
3473,2/04/2023 10:05:00 am,South Point Casino,89183,NLH,60,43,17,0.7166666666666667,No Limit Hold'em
3474,2/04/2023 11:00:00 am,Horseshoe Las Vegas,89109,NLH,75,50,25,0.6666666666666666,No Limit Hold'em
3475,2/04/2023 11:00:00 am,MGM Grand,89109,NLH,100,75,25,0.75,No Limit Hold'em
3476,2/04/2023 11:00:00 am,Wynn Casino,89109,NLH,300,256,44,0.8533333333333334,No Limit Hold'em
3477,2/04/2023 11:05:00 am,The Orleans Casino,89103,NLH,150,118,32,0.7866666666666666,No-Limit Hold'em Monster Stack
3478,2/04/2023 11:10:00 am,Venetian Casino,89109,NLH,800,690,110,0.8625,Deepstack Showdown Jan '23 - Event #44 - No Limit Hold'em UltimateStack
3479,2/04/2023 12:10:00 pm,Sahara Las Vegas,89109,NLH,60,48,12,0.8,$60 NLHE Daily
3480,2/04/2023 1:00:00 pm,Aria Casino,89158,NLH,240,195,45,0.8125,No Limit Hold'em
3481,2/04/2023 2:00:00 pm,Caesars Palace,89109,NLH,150,115,35,0.7666666666666667,No Limit Hold'em
3482,2/04/2023 2:00:00 pm,MGM Grand,89109,NLH,100,75,25,0.75,No Limit Hold'em Turbo
3483,2/04/2023 2:00:00 pm,Horseshoe Las Vegas,89109,NLH,160,115,45,0.71875,No Limit Hold'em Saturday
3484,2/04/2023 2:05:00 pm,South Point Casino,89183,NLH,60,43,17,0.7166666666666667,No Limit Hold'em Turbo
3485,2/04/2023 3:05:00 pm,Resorts World Las Vegas,89109,MLO8,160,130,30,0.8125,LADIES OMAHA 8 BY PLON
3486,2/04/2023 4:00:00 pm,MGM Grand,89109,PLO,150,120,30,0.8,Double Board Bomb Pot PLO
3487,2/04/2023 4:00:00 pm,Sahara Las Vegas,89109,NLCRPI,60,48,12,0.8,$60 NL Crazy Pineapple
3488,2/04/2023 5:00:00 pm,Horseshoe Las Vegas,89109,NLH,75,50,25,0.6666666666666666,No Limit Hold'em
3489,2/04/2023 6:00:00 pm,Caesars Palace,89109,NLH,100,75,25,0.75,No Limit Hold'em
3490,2/04/2023 6:05:00 pm,South Point Casino,89183,NLH,150,118,32,0.7866666666666666,No Limit Hold'em Deep Stack
3491,2/04/2023 6:30:00 pm,Poker Palace Casino,89030,NLH,20,10,10,0.5,No Limit Hold'em
3492,2/04/2023 7:00:00 pm,MGM Grand,89109,NLH,100,75,25,0.75,No Limit Hold'em
3493,2/04/2023 7:05:00 pm,The Orleans Casino,89103,NLH,220,188,32,0.8545454545454545,No Limit Hold'em Bounty
3494,2/04/2023 8:00:00 pm,Horseshoe Las Vegas,89109,NLH,75,50,25,0.6666666666666666,No Limit Hold'em
3495,2/04/2023 8:00:00 pm,Mandalay Bay,89119,NLH,150,125,25,0.8333333333333334,No Limit Hold'em Saturday Night Classic
3496,2/04/2023 8:30:00 pm,Sahara Las Vegas,89109,NLH,60,48,12,0.8,$60 NLHE Daily
3497,2/04/2023 9:00:00 pm,Caesars Palace,89109,NLH,150,115,35,0.7666666666666667,No Limit Hold'em
3498,2/04/2023 10:05:00 pm,South Point Casino,89183,NLH,60,47,13,0.7833333333333333,No Limit Hold'em Turbo
3499,2/04/2023 11:00:00 pm,Horseshoe Las Vegas,89109,NLH,75,50,25,0.6666666666666666,No Limit Hold'em
3500,2/04/2023 11:59:00 pm,MGM Grand,89109,NLH,100,75,25,0.75,Midnight Maddness Hyper Turbo
3501,2/05/2023 12:00:00 am,Caesars Palace,89109,NLH,100,75,25,0.75,No Limit Hold'em
3502,2/05/2023 9:00:00 am,Horseshoe Las Vegas,89109,NLH,75,50,25,0.6666666666666666,No Limit Hold'em
3503,2/05/2023 10:00:00 am,Caesars Palace,89109,NLH,100,75,25,0.75,No Limit Hold'em
3504,2/05/2023 10:05:00 am,South Point Casino,89183,NLH,60,43,17,0.7166666666666667,No Limit Hold'em
3505,2/05/2023 11:00:00 am,Horseshoe Las Vegas,89109,NLH,75,50,25,0.6666666666666666,No Limit Hold'em
3506,2/05/2023 11:00:00 am,MGM Grand,89109,NLH,100,75,25,0.75,No Limit Hold'em
3507,2/05/2023 11:05:00 am,The Orleans Casino,89103,NLH,200,148,52,0.74,Sunday Special No-Limit Hold'em
3508,2/05/2023 12:00:00 pm,Wynn Casino,89109,NLH,200,165,35,0.825,No Limit Hold'em
3509,2/05/2023 12:10:00 pm,Venetian Casino,89109,NLH,500,422,78,0.844,Deepstack Showdown Jan '23 - Event #47 - No Limit Hold'em EpicStack Freezeout
3510,2/05/2023 1:00:00 pm,Aria Casino,89158,NLH,160,125,35,0.78125,No Limit Hold'em
3511,2/05/2023 1:10:00 pm,Sahara Las Vegas,89109,NLH,75,65,10,0.8666666666666667,$75 NLHE Bounty
3512,2/05/2023 2:00:00 pm,Horseshoe Las Vegas,89109,NLH,75,50,25,0.6666666666666666,No Limit Hold'em
3513,2/05/2023 2:00:00 pm,Caesars Palace,89109,NLH,150,115,35,0.7666666666666667,No Limit Hold'em
3514,2/05/2023 2:00:00 pm,MGM Grand,89109,NLH,100,75,25,0.75,No Limit Hold'em Turbo
3515,2/05/2023 4:00:00 pm,Sahara Las Vegas,89109,NLCRPI,60,48,12,0.8,$60 NL Crazy Pineapple
3516,2/05/2023 4:05:00 pm,The Orleans Casino,89103,ROSE,200,158,42,0.79,R.O.S.E.
3517,2/05/2023 5:00:00 pm,Horseshoe Las Vegas,89109,NLH,75,50,25,0.6666666666666666,No Limit Hold'em
3518,2/05/2023 5:00:00 pm,Bellagio Casino,89109,NLH,160,125,35,0.78125,No Limit Hold'em
3519,2/05/2023 6:00:00 pm,Caesars Palace,89109,NLH,100,75,25,0.75,No Limit Hold'em
3520,2/05/2023 6:05:00 pm,South Point Casino,89183,NLH,150,118,32,0.7866666666666666,No Limit Hold'em Deep Stack
3521,2/05/2023 6:10:00 pm,Venetian Casino,89109,NLH,300,250,50,0.8333333333333334,Deepstack Showdown Jan '23 - Event #48 - No Limit Hold'em Bounty Survivor
3522,2/05/2023 7:00:00 pm,MGM Grand,89109,NLH,100,75,25,0.75,No Limit Hold'em
3523,2/05/2023 8:00:00 pm,Mandalay Bay,89119,NLH,60,40,20,0.6666666666666666,No Limit Hold'em
3524,2/05/2023 8:00:00 pm,Horseshoe Las Vegas,89109,NLH,75,50,25,0.6666666666666666,No Limit Hold'em
3525,2/05/2023 8:30:00 pm,Sahara Las Vegas,89109,NLH,60,48,12,0.8,$60 NLHE Daily
3526,2/05/2023 9:00:00 pm,Caesars Palace,89109,NLH,150,115,35,0.7666666666666667,No Limit Hold'em
3527,2/05/2023 10:05:00 pm,South Point Casino,89183,NLH,60,47,13,0.7833333333333333,No Limit Hold'em Turbo
3528,2/05/2023 11:00:00 pm,Horseshoe Las Vegas,89109,NLH,75,50,25,0.6666666666666666,No Limit Hold'em
3529,2/05/2023 11:59:00 pm,MGM Grand,89109,NLH,100,75,25,0.75,Midnight Maddness Hyper Turbo
3530,2/06/2023 12:00:00 am,Caesars Palace,89109,NLH,100,75,25,0.75,No Limit Hold'em
3531,2/06/2023 9:00:00 am,Horseshoe Las Vegas,89109,NLH,75,50,25,0.6666666666666666,No Limit Hold'em
3532,2/06/2023 10:00:00 am,Caesars Palace,89109,NLH,100,75,25,0.75,No Limit Hold'em
3533,2/06/2023 10:05:00 am,South Point Casino,89183,NLH,60,43,17,0.7166666666666667,No Limit Hold'em
3534,2/06/2023 11:00:00 am,Horseshoe Las Vegas,89109,NLH,75,50,25,0.6666666666666666,No Limit Hold'em
3535,2/06/2023 11:00:00 am,MGM Grand,89109,NLH,100,75,25,0.75,No Limit Hold'em
3536,2/06/2023 11:05:00 am,The Orleans Casino,89103,NLH,100,76,24,0.76,Super Stack No-Limit Hold'em
3537,2/06/2023 11:10:00 am,Venetian Casino,89109,NLH,600,510,90,0.85,Deepstack Showdown Jan '23 - Event #49 - No Limit Hold'em MonsterStack
3538,2/06/2023 12:00:00 pm,Wynn Casino,89109,NLH,200,165,35,0.825,No Limit Hold'em
3539,2/06/2023 12:10:00 pm,Sahara Las Vegas,89109,NLH,60,48,12,0.8,$60 NLHE Daily
3540,2/06/2023 1:00:00 pm,Aria Casino,89158,NLH,160,125,35,0.78125,No Limit Hold'em
3541,2/06/2023 2:00:00 pm,Horseshoe Las Vegas,89109,NLH,75,50,25,0.6666666666666666,No Limit Hold'em
3542,2/06/2023 2:00:00 pm,Caesars Palace,89109,NLH,150,115,35,0.7666666666666667,No Limit Hold'em
3543,2/06/2023 2:00:00 pm,MGM Grand,89109,NLH,100,75,25,0.75,No Limit Hold'em Turbo
3544,2/06/2023 2:05:00 pm,South Point Casino,89183,NLH,60,43,17,0.7166666666666667,No Limit Hold'em Turbo
3545,2/06/2023 4:00:00 pm,Sahara Las Vegas,89109,NLCRPI,60,48,12,0.8,$60 NL Crazy Pineapple
3546,2/06/2023 4:05:00 pm,The Orleans Casino,89103,HORSE,125,98,27,0.784,H.O.R.S.E.
3547,2/06/2023 5:00:00 pm,Horseshoe Las Vegas,89109,NLH,75,50,25,0.6666666666666666,No Limit Hold'em
3548,2/06/2023 5:00:00 pm,Bellagio Casino,89109,NLH,160,125,35,0.78125,No Limit Hold'em
3549,2/06/2023 6:00:00 pm,Caesars Palace,89109,NLH,100,75,25,0.75,No Limit Hold'em
3550,2/06/2023 6:05:00 pm,South Point Casino,89183,NLH,60,43,17,0.7166666666666667,No Limit Hold'em
3551,2/06/2023 6:10:00 pm,Venetian Casino,89109,NLH,300,250,50,0.8333333333333334,Deepstack Showdown Jan '23 - Event #50 - No Limit Hold'em Survivor
3552,2/06/2023 7:00:00 pm,MGM Grand,89109,NLH,100,75,25,0.75,No Limit Hold'em
3553,2/06/2023 7:05:00 pm,The Orleans Casino,89103,NLH,125,98,27,0.784,No Limit Crazy Pineapple
3554,2/06/2023 8:00:00 pm,Mandalay Bay,89119,NLH,60,40,20,0.6666666666666666,No Limit Hold'em
3555,2/06/2023 8:00:00 pm,Horseshoe Las Vegas,89109,NLH,75,50,25,0.6666666666666666,No Limit Hold'em
3556,2/06/2023 8:30:00 pm,Sahara Las Vegas,89109,NLH,60,48,12,0.8,$60 NLHE Daily
3557,2/06/2023 9:00:00 pm,Caesars Palace,89109,NLH,150,115,35,0.7666666666666667,No Limit Hold'em
3558,2/06/2023 10:05:00 pm,South Point Casino,89183,NLH,60,47,13,0.7833333333333333,No Limit Hold'em Turbo
3559,2/06/2023 11:00:00 pm,Horseshoe Las Vegas,89109,NLH,75,50,25,0.6666666666666666,No Limit Hold'em
3560,2/06/2023 11:59:00 pm,MGM Grand,89109,NLH,100,75,25,0.75,Midnight Maddness Hyper Turbo
3561,2/07/2023 12:00:00 am,Caesars Palace,89109,NLH,100,75,25,0.75,No Limit Hold'em
3562,2/07/2023 9:00:00 am,Horseshoe Las Vegas,89109,NLH,75,50,25,0.6666666666666666,No Limit Hold'em
3563,2/07/2023 10:00:00 am,Caesars Palace,89109,NLH,100,75,25,0.75,No Limit Hold'em
3564,2/07/2023 10:05:00 am,South Point Casino,89183,NLH,60,43,17,0.7166666666666667,No Limit Hold'em
3565,2/07/2023 11:00:00 am,Horseshoe Las Vegas,89109,NLH,75,50,25,0.6666666666666666,No Limit Hold'em
3566,2/07/2023 11:00:00 am,MGM Grand,89109,NLH,100,75,25,0.75,No Limit Hold'em
3567,2/07/2023 11:05:00 am,The Orleans Casino,89103,NLH,100,76,24,0.76,Super Stack No-Limit Hold'em
3568,2/07/2023 11:10:00 am,Venetian Casino,89109,NLH,1100,965,135,0.8772727272727273,Deepstack Showdown Jan '23 - Event #51 - NLH MSPT Poker Bowl
3569,2/07/2023 12:00:00 pm,Wynn Casino,89109,NLH,200,165,35,0.825,No Limit Hold'em
3570,2/07/2023 12:10:00 pm,Sahara Las Vegas,89109,NLH,60,48,12,0.8,$60 NLHE Daily
3571,2/07/2023 1:00:00 pm,Aria Casino,89158,NLH,160,125,35,0.78125,No Limit Hold'em
3572,2/07/2023 2:00:00 pm,Horseshoe Las Vegas,89109,NLH,75,50,25,0.6666666666666666,No Limit Hold'em
3573,2/07/2023 2:00:00 pm,Caesars Palace,89109,NLH,150,115,35,0.7666666666666667,No Limit Hold'em
3574,2/07/2023 2:00:00 pm,MGM Grand,89109,NLH,100,75,25,0.75,No Limit Hold'em Turbo
3575,2/07/2023 2:05:00 pm,South Point Casino,89183,FLO8,60,43,17,0.7166666666666667,Omaha 8/B
3576,2/07/2023 4:00:00 pm,Sahara Las Vegas,89109,NLCRPI,60,48,12,0.8,$60 NL Crazy Pineapple
3577,2/07/2023 5:00:00 pm,Horseshoe Las Vegas,89109,NLH,75,50,25,0.6666666666666666,No Limit Hold'em
3578,2/07/2023 5:00:00 pm,Bellagio Casino,89109,NLH,160,125,35,0.78125,No Limit Hold'em
3579,2/07/2023 6:00:00 pm,Caesars Palace,89109,NLH,100,75,25,0.75,No Limit Hold'em
3580,2/07/2023 6:05:00 pm,South Point Casino,89183,NLH,60,43,17,0.7166666666666667,No Limit Hold'em
3581,2/07/2023 6:10:00 pm,Venetian Casino,89109,NLH,300,250,50,0.8333333333333334,Deepstack Showdown Jan '23 - Event #52 - No Limit Hold'em Survivor
3582,2/07/2023 7:00:00 pm,MGM Grand,89109,NLH,100,75,25,0.75,No Limit Hold'em
3583,2/07/2023 7:05:00 pm,The Orleans Casino,89103,NLH,100,76,24,0.76,Super Stack No-Limit Hold'em
3584,2/07/2023 8:00:00 pm,Horseshoe Las Vegas,89109,NLH,75,50,25,0.6666666666666666,No Limit Hold'em
3585,2/07/2023 8:30:00 pm,Sahara Las Vegas,89109,NLH,60,48,12,0.8,$60 NLHE Daily
3586,2/07/2023 9:00:00 pm,Caesars Palace,89109,NLH,150,115,35,0.7666666666666667,No Limit Hold'em
3587,2/07/2023 10:05:00 pm,South Point Casino,89183,NLH,60,47,13,0.7833333333333333,No Limit Hold'em Turbo
3588,2/07/2023 11:00:00 pm,Horseshoe Las Vegas,89109,NLH,75,50,25,0.6666666666666666,No Limit Hold'em
3589,2/07/2023 11:59:00 pm,MGM Grand,89109,NLH,100,75,25,0.75,Midnight Maddness Hyper Turbo
3590,2/08/2023 12:00:00 am,Caesars Palace,89109,NLH,100,75,25,0.75,No Limit Hold'em
3591,2/08/2023 9:00:00 am,Horseshoe Las Vegas,89109,NLH,75,50,25,0.6666666666666666,No Limit Hold'em
3592,2/08/2023 10:00:00 am,Caesars Palace,89109,NLH,100,75,25,0.75,No Limit Hold'em
3593,2/08/2023 10:05:00 am,South Point Casino,89183,NLH,60,43,17,0.7166666666666667,No Limit Hold'em
3594,2/08/2023 11:00:00 am,Horseshoe Las Vegas,89109,NLH,75,50,25,0.6666666666666666,No Limit Hold'em
3595,2/08/2023 11:00:00 am,MGM Grand,89109,NLH,100,75,25,0.75,No Limit Hold'em
3596,2/08/2023 11:05:00 am,The Orleans Casino,89103,NLH,100,76,24,0.76,Super Stack No-Limit Hold'em
3597,2/08/2023 11:10:00 am,Venetian Casino,89109,NLH,1100,965,135,0.8772727272727273,Deepstack Showdown Jan '23 - Event #51 - NLH MSPT Poker Bowl
3598,2/08/2023 12:00:00 pm,Wynn Casino,89109,NLH,200,165,35,0.825,No Limit Hold'em
3599,2/08/2023 12:10:00 pm,Sahara Las Vegas,89109,NLH,60,48,12,0.8,$60 NLHE Daily
3600,2/08/2023 1:00:00 pm,Aria Casino,89158,NLH,160,125,35,0.78125,No Limit Hold'em
3601,2/08/2023 2:00:00 pm,Horseshoe Las Vegas,89109,NLH,75,50,25,0.6666666666666666,No Limit Hold'em
3602,2/08/2023 2:00:00 pm,Caesars Palace,89109,NLH,150,115,35,0.7666666666666667,No Limit Hold'em
3603,2/08/2023 2:00:00 pm,MGM Grand,89109,NLH,100,75,25,0.75,No Limit Hold'em Turbo
3604,2/08/2023 2:05:00 pm,South Point Casino,89183,NLH,60,43,17,0.7166666666666667,No Limit Hold'em Turbo
3605,2/08/2023 4:00:00 pm,Sahara Las Vegas,89109,NLCRPI,60,48,12,0.8,$60 NL Crazy Pineapple
3606,2/08/2023 4:05:00 pm,The Orleans Casino,89103,O8/S8,150,118,32,0.7866666666666666,Omaha 8/B / Stud 8
3607,2/08/2023 5:00:00 pm,Horseshoe Las Vegas,89109,NLH,75,50,25,0.6666666666666666,No Limit Hold'em
3608,2/08/2023 5:00:00 pm,Bellagio Casino,89109,NLH,160,125,35,0.78125,No Limit Hold'em
3609,2/08/2023 6:00:00 pm,Caesars Palace,89109,NLH,100,75,25,0.75,No Limit Hold'em
3610,2/08/2023 6:05:00 pm,South Point Casino,89183,NLH,150,118,32,0.7866666666666666,No Limit Hold'em Deep Stack
3611,2/08/2023 7:00:00 pm,MGM Grand,89109,NLH,100,75,25,0.75,No Limit Hold'em
3612,2/08/2023 7:05:00 pm,The Orleans Casino,89103,NLH,125,100,25,0.8,No Limit Hold'em Survivor
3613,2/08/2023 7:10:00 pm,Venetian Casino,89109,NLH,200,165,35,0.825,Deepstack Showdown Jan '23 - Event #53 - NLH Mega Satellite
3614,2/08/2023 8:00:00 pm,Horseshoe Las Vegas,89109,NLH,75,50,25,0.6666666666666666,No Limit Hold'em
3615,2/08/2023 8:30:00 pm,Sahara Las Vegas,89109,NLH,60,48,12,0.8,*$60 NLHE Daily
3616,2/08/2023 9:00:00 pm,Caesars Palace,89109,NLH,150,115,35,0.7666666666666667,No Limit Hold'em
3617,2/08/2023 10:05:00 pm,South Point Casino,89183,NLH,60,47,13,0.7833333333333333,No Limit Hold'em Turbo
3618,2/08/2023 11:00:00 pm,Horseshoe Las Vegas,89109,NLH,75,50,25,0.6666666666666666,No Limit Hold'em
3619,2/08/2023 11:59:00 pm,MGM Grand,89109,NLH,100,75,25,0.75,Midnight Maddness Hyper Turbo
3620,2/09/2023 12:00:00 am,Caesars Palace,89109,NLH,100,75,25,0.75,No Limit Hold'em
3621,2/09/2023 9:00:00 am,Horseshoe Las Vegas,89109,NLH,75,50,25,0.6666666666666666,No Limit Hold'em
3622,2/09/2023 10:00:00 am,Caesars Palace,89109,NLH,100,75,25,0.75,No Limit Hold'em
3623,2/09/2023 10:05:00 am,South Point Casino,89183,NLH,60,43,17,0.7166666666666667,No Limit Hold'em
3624,2/09/2023 11:00:00 am,Horseshoe Las Vegas,89109,NLH,75,50,25,0.6666666666666666,No Limit Hold'em
3625,2/09/2023 11:00:00 am,MGM Grand,89109,NLH,100,75,25,0.75,No Limit Hold'em
3626,2/09/2023 11:05:00 am,The Orleans Casino,89103,NLH,100,76,24,0.76,Super Stack No-Limit Hold'em
3627,2/09/2023 11:10:00 am,Venetian Casino,89109,NLH,1600,1425,175,0.890625,Deepstack Showdown Jan '23 - Event #54 - NLH MSPT Poker Bowl
3628,2/09/2023 12:00:00 pm,Wynn Casino,89109,NLH,200,165,35,0.825,No Limit Hold'em
3629,2/09/2023 12:10:00 pm,Sahara Las Vegas,89109,NLH,60,48,12,0.8,$60 NLHE Daily
3630,2/09/2023 1:00:00 pm,Aria Casino,89158,NLH,160,125,35,0.78125,No Limit Hold'em
3631,2/09/2023 2:00:00 pm,Horseshoe Las Vegas,89109,NLH,75,50,25,0.6666666666666666,No Limit Hold'em
3632,2/09/2023 2:00:00 pm,Caesars Palace,89109,NLH,150,115,35,0.7666666666666667,No Limit Hold'em
3633,2/09/2023 2:00:00 pm,MGM Grand,89109,NLH,100,75,25,0.75,No Limit Hold'em Turbo
3634,2/09/2023 2:00:00 pm,South Point Casino,89183,O8/S8,150,118,32,0.7866666666666666,Omaha 8 / Stud 8
3635,2/09/2023 4:00:00 pm,Sahara Las Vegas,89109,NLCRPI,60,48,12,0.8,$60 NL Crazy Pineapple
3636,2/09/2023 5:00:00 pm,Horseshoe Las Vegas,89109,NLH,75,50,25,0.6666666666666666,No Limit Hold'em
3637,2/09/2023 5:00:00 pm,Bellagio Casino,89109,NLH,160,125,35,0.78125,No Limit Hold'em
3638,2/09/2023 6:00:00 pm,Caesars Palace,89109,NLH,100,75,25,0.75,No Limit Hold'em
3639,2/09/2023 6:05:00 pm,South Point Casino,89183,NLH,60,43,17,0.7166666666666667,No Limit Hold'em
3640,2/09/2023 7:00:00 pm,MGM Grand,89109,NLH,100,75,25,0.75,No Limit Hold'em
3641,2/09/2023 7:05:00 pm,The Orleans Casino,89103,NLH,100,76,24,0.76,Super Stack No-Limit Hold'em
3642,2/09/2023 7:10:00 pm,Venetian Casino,89109,NLH,200,165,35,0.825,Deepstack Showdown Jan '23 - Event #55 - NLH Mega Satellite
3643,2/09/2023 8:00:00 pm,Mandalay Bay,89119,NLH,60,40,20,0.6666666666666666,No Limit Hold'em
3644,2/09/2023 8:00:00 pm,Horseshoe Las Vegas,89109,NLH,75,50,25,0.6666666666666666,No Limit Hold'em
3645,2/09/2023 8:30:00 pm,Sahara Las Vegas,89109,NLH,60,48,12,0.8,$60 NLHE Daily
3646,2/09/2023 9:00:00 pm,Caesars Palace,89109,NLH,150,115,35,0.7666666666666667,No Limit Hold'em
3647,2/09/2023 10:05:00 pm,South Point Casino,89183,NLH,60,47,13,0.7833333333333333,No Limit Hold'em Turbo
3648,2/09/2023 11:00:00 pm,Horseshoe Las Vegas,89109,NLH,75,50,25,0.6666666666666666,No Limit Hold'em
3649,2/09/2023 11:59:00 pm,MGM Grand,89109,NLH,100,75,25,0.75,Midnight Maddness Hyper Turbo
3650,2/10/2023 12:00:00 am,Caesars Palace,89109,NLH,100,75,25,0.75,No Limit Hold'em
3651,2/10/2023 9:00:00 am,Horseshoe Las Vegas,89109,NLH,75,50,25,0.6666666666666666,No Limit Hold'em
3652,2/10/2023 10:00:00 am,Caesars Palace,89109,NLH,100,75,25,0.75,No Limit Hold'em
3653,2/10/2023 10:05:00 am,South Point Casino,89183,NLH,60,43,17,0.7166666666666667,No Limit Hold'em
3654,2/10/2023 11:00:00 am,Horseshoe Las Vegas,89109,NLH,75,50,25,0.6666666666666666,No Limit Hold'em
3655,2/10/2023 11:00:00 am,MGM Grand,89109,NLH,100,75,25,0.75,No Limit Hold'em
3656,2/10/2023 11:00:00 am,Wynn Casino,89109,NLH,230,190,40,0.8260869565217391,No Limit Hold'em
3657,2/10/2023 11:05:00 am,The Orleans Casino,89103,NLH,100,76,24,0.76,Super Stack No-Limit Hold'em
3658,2/10/2023 11:10:00 am,Venetian Casino,89109,NLH,1600,1425,175,0.890625,Deepstack Showdown Jan '23 - Event #54 - NLH MSPT Poker Bowl
3659,2/10/2023 12:10:00 pm,Sahara Las Vegas,89109,NLH,60,48,12,0.8,$60 NLHE Daily
3660,2/10/2023 1:00:00 pm,Aria Casino,89158,NLH,240,195,45,0.8125,No Limit Hold'em
3661,2/10/2023 2:00:00 pm,Horseshoe Las Vegas,89109,NLH,75,50,25,0.6666666666666666,No Limit Hold'em
3662,2/10/2023 2:00:00 pm,Caesars Palace,89109,NLH,150,115,35,0.7666666666666667,No Limit Hold'em
3663,2/10/2023 2:00:00 pm,MGM Grand,89109,NLH,100,75,25,0.75,No Limit Hold'em Turbo
3664,2/10/2023 2:05:00 pm,South Point Casino,89183,NLH,60,43,17,0.7166666666666667,No Limit Hold'em Turbo
3665,2/10/2023 4:00:00 pm,Sahara Las Vegas,89109,NLCRPI,60,48,12,0.8,$60 NL Crazy Pineapple
3666,2/10/2023 5:00:00 pm,Horseshoe Las Vegas,89109,NLH,75,50,25,0.6666666666666666,No Limit Hold'em
3667,2/10/2023 6:00:00 pm,Caesars Palace,89109,NLH,100,75,25,0.75,No Limit Hold'em
3668,2/10/2023 6:00:00 pm,South Point Casino,89183,NLH,150,118,32,0.7866666666666666,No Limit Hold'em Double Green Chip Bounty
3669,2/10/2023 6:30:00 pm,Poker Palace Casino,89030,NLH,20,10,10,0.5,No Limit Hold'em
3670,2/10/2023 7:00:00 pm,MGM Grand,89109,NLH,100,75,25,0.75,No Limit Hold'em
3671,2/10/2023 7:05:00 pm,The Orleans Casino,89103,NLH,150,118,32,0.7866666666666666,No-Limit Hold'em
3672,2/10/2023 8:00:00 pm,Mandalay Bay,89119,NLH,60,40,20,0.6666666666666666,No Limit Hold'em
3673,2/10/2023 8:00:00 pm,Horseshoe Las Vegas,89109,NLH,75,50,25,0.6666666666666666,No Limit Hold'em
3674,2/10/2023 8:30:00 pm,Sahara Las Vegas,89109,NLH,60,48,12,0.8,$60 NLHE Daily
3675,2/10/2023 9:00:00 pm,Caesars Palace,89109,NLH,150,115,35,0.7666666666666667,No Limit Hold'em
3676,2/10/2023 10:05:00 pm,South Point Casino,89183,NLH,60,47,13,0.7833333333333333,No Limit Hold'em Turbo
3677,2/10/2023 11:00:00 pm,Horseshoe Las Vegas,89109,NLH,75,50,25,0.6666666666666666,No Limit Hold'em
3678,2/10/2023 11:59:00 pm,MGM Grand,89109,NLH,100,75,25,0.75,Midnight Maddness Hyper Turbo
3679,2/11/2023 12:00:00 am,Caesars Palace,89109,NLH,100,75,25,0.75,No Limit Hold'em
3680,2/11/2023 9:00:00 am,Horseshoe Las Vegas,89109,NLH,75,50,25,0.6666666666666666,No Limit Hold'em
3681,2/11/2023 10:00:00 am,Caesars Palace,89109,NLH,100,75,25,0.75,No Limit Hold'em
3682,2/11/2023 10:05:00 am,South Point Casino,89183,NLH,60,43,17,0.7166666666666667,No Limit Hold'em
3683,2/11/2023 11:00:00 am,Horseshoe Las Vegas,89109,NLH,75,50,25,0.6666666666666666,No Limit Hold'em
3684,2/11/2023 11:00:00 am,MGM Grand,89109,NLH,100,75,25,0.75,No Limit Hold'em
3685,2/11/2023 11:00:00 am,Wynn Casino,89109,NLH,300,256,44,0.8533333333333334,No Limit Hold'em
3686,2/11/2023 11:05:00 am,The Orleans Casino,89103,NLH,150,118,32,0.7866666666666666,No-Limit Hold'em Monster Stack
3687,2/11/2023 12:10:00 pm,Venetian Casino,89109,NLH,1100,970,130,0.8818181818181818,Deepstack Showdown Jan '23 - Event #56 - No Limit Hold'em Monster Bounty
3688,2/11/2023 12:10:00 pm,Sahara Las Vegas,89109,NLH,60,48,12,0.8,$60 NLHE Daily
3689,2/11/2023 1:00:00 pm,Aria Casino,89158,NLH,240,195,45,0.8125,No Limit Hold'em
3690,2/11/2023 2:00:00 pm,Caesars Palace,89109,NLH,150,115,35,0.7666666666666667,No Limit Hold'em
3691,2/11/2023 2:00:00 pm,MGM Grand,89109,NLH,100,75,25,0.75,No Limit Hold'em Turbo
3692,2/11/2023 2:00:00 pm,Horseshoe Las Vegas,89109,NLH,160,115,45,0.71875,No Limit Hold'em Saturday
3693,2/11/2023 2:05:00 pm,South Point Casino,89183,NLH,60,43,17,0.7166666666666667,No Limit Hold'em Turbo
3694,2/11/2023 4:00:00 pm,MGM Grand,89109,PLO,150,120,30,0.8,Double Board Bomb Pot PLO
3695,2/11/2023 4:00:00 pm,Sahara Las Vegas,89109,NLCRPI,60,48,12,0.8,$60 NL Crazy Pineapple
3696,2/11/2023 5:00:00 pm,Horseshoe Las Vegas,89109,NLH,75,50,25,0.6666666666666666,No Limit Hold'em
3697,2/11/2023 6:00:00 pm,Caesars Palace,89109,NLH,100,75,25,0.75,No Limit Hold'em
3698,2/11/2023 6:05:00 pm,South Point Casino,89183,NLH,150,118,32,0.7866666666666666,No Limit Hold'em Deep Stack
3699,2/11/2023 6:30:00 pm,Poker Palace Casino,89030,NLH,20,10,10,0.5,No Limit Hold'em
3700,2/11/2023 7:00:00 pm,MGM Grand,89109,NLH,100,75,25,0.75,No Limit Hold'em
3701,2/11/2023 7:05:00 pm,The Orleans Casino,89103,NLH,220,188,32,0.8545454545454545,No Limit Hold'em Bounty
3702,2/11/2023 8:00:00 pm,Horseshoe Las Vegas,89109,NLH,75,50,25,0.6666666666666666,No Limit Hold'em
3703,2/11/2023 8:00:00 pm,Mandalay Bay,89119,NLH,150,125,25,0.8333333333333334,No Limit Hold'em Saturday Night Classic
3704,2/11/2023 8:30:00 pm,Sahara Las Vegas,89109,NLH,60,48,12,0.8,$60 NLHE Daily
3705,2/11/2023 9:00:00 pm,Caesars Palace,89109,NLH,150,115,35,0.7666666666666667,No Limit Hold'em
3706,2/11/2023 10:05:00 pm,South Point Casino,89183,NLH,60,47,13,0.7833333333333333,No Limit Hold'em Turbo
3707,2/11/2023 11:00:00 pm,Horseshoe Las Vegas,89109,NLH,75,50,25,0.6666666666666666,No Limit Hold'em
3708,2/11/2023 11:59:00 pm,MGM Grand,89109,NLH,100,75,25,0.75,Midnight Maddness Hyper Turbo
3709,2/12/2023 12:00:00 am,Caesars Palace,89109,NLH,100,75,25,0.75,No Limit Hold'em
3710,2/12/2023 9:00:00 am,Horseshoe Las Vegas,89109,NLH,75,50,25,0.6666666666666666,No Limit Hold'em
3711,2/12/2023 10:00:00 am,Caesars Palace,89109,NLH,100,75,25,0.75,No Limit Hold'em
3712,2/12/2023 10:05:00 am,South Point Casino,89183,NLH,60,43,17,0.7166666666666667,No Limit Hold'em
3713,2/12/2023 11:00:00 am,Horseshoe Las Vegas,89109,NLH,75,50,25,0.6666666666666666,No Limit Hold'em
3714,2/12/2023 11:00:00 am,MGM Grand,89109,NLH,100,75,25,0.75,No Limit Hold'em
3715,2/12/2023 11:05:00 am,The Orleans Casino,89103,NLH,200,148,52,0.74,Sunday Special No-Limit Hold'em
3716,2/12/2023 12:00:00 pm,Wynn Casino,89109,NLH,200,165,35,0.825,No Limit Hold'em
3717,2/12/2023 1:00:00 pm,Aria Casino,89158,NLH,160,125,35,0.78125,No Limit Hold'em
3718,2/12/2023 2:00:00 pm,Horseshoe Las Vegas,89109,NLH,75,50,25,0.6666666666666666,No Limit Hold'em
3719,2/12/2023 2:00:00 pm,Caesars Palace,89109,NLH,150,115,35,0.7666666666666667,No Limit Hold'em
3720,2/12/2023 2:00:00 pm,MGM Grand,89109,NLH,100,75,25,0.75,No Limit Hold'em Turbo
3721,2/12/2023 4:05:00 pm,The Orleans Casino,89103,ROSE,200,158,42,0.79,R.O.S.E.
3722,2/12/2023 5:00:00 pm,Horseshoe Las Vegas,89109,NLH,75,50,25,0.6666666666666666,No Limit Hold'em
3723,2/12/2023 5:00:00 pm,Bellagio Casino,89109,NLH,160,125,35,0.78125,No Limit Hold'em
3724,2/12/2023 6:00:00 pm,Caesars Palace,89109,NLH,100,75,25,0.75,No Limit Hold'em
3725,2/12/2023 6:05:00 pm,South Point Casino,89183,NLH,150,118,32,0.7866666666666666,No Limit Hold'em Deep Stack
3726,2/12/2023 7:00:00 pm,MGM Grand,89109,NLH,100,75,25,0.75,No Limit Hold'em
3727,2/12/2023 7:10:00 pm,Venetian Casino,89109,NLH,300,250,50,0.8333333333333334,Deepstack Showdown Jan '23 - Event #57 - No Limit Hold'em Bounty
3728,2/12/2023 8:00:00 pm,Mandalay Bay,89119,NLH,60,40,20,0.6666666666666666,No Limit Hold'em
3729,2/12/2023 8:00:00 pm,Horseshoe Las Vegas,89109,NLH,75,50,25,0.6666666666666666,No Limit Hold'em
3730,2/12/2023 9:00:00 pm,Caesars Palace,89109,NLH,150,115,35,0.7666666666666667,No Limit Hold'em
3731,2/12/2023 10:05:00 pm,South Point Casino,89183,NLH,60,47,13,0.7833333333333333,No Limit Hold'em Turbo
3732,2/12/2023 11:00:00 pm,Horseshoe Las Vegas,89109,NLH,75,50,25,0.6666666666666666,No Limit Hold'em
3733,2/13/2023 12:00:00 am,Caesars Palace,89109,NLH,100,75,25,0.75,No Limit Hold'em
3734,2/13/2023 9:00:00 am,Horseshoe Las Vegas,89109,NLH,75,50,25,0.6666666666666666,No Limit Hold'em
3735,2/13/2023 10:00:00 am,Caesars Palace,89109,NLH,100,75,25,0.75,No Limit Hold'em
3736,2/13/2023 10:05:00 am,South Point Casino,89183,NLH,60,43,17,0.7166666666666667,No Limit Hold'em
3737,2/13/2023 11:00:00 am,Horseshoe Las Vegas,89109,NLH,75,50,25,0.6666666666666666,No Limit Hold'em
3738,2/13/2023 11:00:00 am,MGM Grand,89109,NLH,100,75,25,0.75,No Limit Hold'em
3739,2/13/2023 11:05:00 am,The Orleans Casino,89103,NLH,100,76,24,0.76,Super Stack No-Limit Hold'em
3740,2/13/2023 12:00:00 pm,Wynn Casino,89109,NLH,200,165,35,0.825,No Limit Hold'em
3741,2/13/2023 1:00:00 pm,Aria Casino,89158,NLH,160,125,35,0.78125,No Limit Hold'em
3742,2/13/2023 2:00:00 pm,Horseshoe Las Vegas,89109,NLH,75,50,25,0.6666666666666666,No Limit Hold'em
3743,2/13/2023 2:00:00 pm,Caesars Palace,89109,NLH,150,115,35,0.7666666666666667,No Limit Hold'em
3744,2/13/2023 2:00:00 pm,MGM Grand,89109,NLH,100,75,25,0.75,No Limit Hold'em Turbo
3745,2/13/2023 2:05:00 pm,South Point Casino,89183,NLH,60,43,17,0.7166666666666667,No Limit Hold'em Turbo
3746,2/13/2023 4:05:00 pm,The Orleans Casino,89103,HORSE,125,98,27,0.784,H.O.R.S.E.
3747,2/13/2023 5:00:00 pm,Horseshoe Las Vegas,89109,NLH,75,50,25,0.6666666666666666,No Limit Hold'em
3748,2/13/2023 5:00:00 pm,Bellagio Casino,89109,NLH,160,125,35,0.78125,No Limit Hold'em
3749,2/13/2023 6:00:00 pm,Caesars Palace,89109,NLH,100,75,25,0.75,No Limit Hold'em
3750,2/13/2023 6:05:00 pm,South Point Casino,89183,NLH,60,43,17,0.7166666666666667,No Limit Hold'em
3751,2/13/2023 7:00:00 pm,MGM Grand,89109,NLH,100,75,25,0.75,No Limit Hold'em
3752,2/13/2023 7:05:00 pm,The Orleans Casino,89103,NLH,125,98,27,0.784,No Limit Crazy Pineapple
3753,2/13/2023 8:00:00 pm,Mandalay Bay,89119,NLH,60,40,20,0.6666666666666666,No Limit Hold'em
3754,2/13/2023 8:00:00 pm,Horseshoe Las Vegas,89109,NLH,75,50,25,0.6666666666666666,No Limit Hold'em
3755,2/13/2023 9:00:00 pm,Caesars Palace,89109,NLH,150,115,35,0.7666666666666667,No Limit Hold'em
3756,2/13/2023 10:05:00 pm,South Point Casino,89183,NLH,60,47,13,0.7833333333333333,No Limit Hold'em Turbo
3757,2/13/2023 11:00:00 pm,Horseshoe Las Vegas,89109,NLH,75,50,25,0.6666666666666666,No Limit Hold'em
3758,2/14/2023 12:00:00 am,Caesars Palace,89109,NLH,100,75,25,0.75,No Limit Hold'em
3759,2/14/2023 9:00:00 am,Horseshoe Las Vegas,89109,NLH,75,50,25,0.6666666666666666,No Limit Hold'em
3760,2/14/2023 10:00:00 am,Caesars Palace,89109,NLH,100,75,25,0.75,No Limit Hold'em
3761,2/14/2023 10:05:00 am,South Point Casino,89183,NLH,60,43,17,0.7166666666666667,No Limit Hold'em
3762,2/14/2023 11:00:00 am,Horseshoe Las Vegas,89109,NLH,75,50,25,0.6666666666666666,No Limit Hold'em
3763,2/14/2023 11:00:00 am,MGM Grand,89109,NLH,100,75,25,0.75,No Limit Hold'em
3764,2/14/2023 11:05:00 am,The Orleans Casino,89103,NLH,100,76,24,0.76,Super Stack No-Limit Hold'em
3765,2/14/2023 12:00:00 pm,Wynn Casino,89109,NLH,200,165,35,0.825,No Limit Hold'em
3766,2/14/2023 1:00:00 pm,Aria Casino,89158,NLH,160,125,35,0.78125,No Limit Hold'em
3767,2/14/2023 2:00:00 pm,Horseshoe Las Vegas,89109,NLH,75,50,25,0.6666666666666666,No Limit Hold'em
3768,2/14/2023 2:00:00 pm,Caesars Palace,89109,NLH,150,115,35,0.7666666666666667,No Limit Hold'em
3769,2/14/2023 2:00:00 pm,MGM Grand,89109,NLH,100,75,25,0.75,No Limit Hold'em Turbo
3770,2/14/2023 2:05:00 pm,South Point Casino,89183,FLO8,60,43,17,0.7166666666666667,Omaha 8/B
3771,2/14/2023 5:00:00 pm,Horseshoe Las Vegas,89109,NLH,75,50,25,0.6666666666666666,No Limit Hold'em
3772,2/14/2023 5:00:00 pm,Bellagio Casino,89109,NLH,160,125,35,0.78125,No Limit Hold'em
3773,2/14/2023 6:00:00 pm,Caesars Palace,89109,NLH,100,75,25,0.75,No Limit Hold'em
3774,2/14/2023 6:05:00 pm,South Point Casino,89183,NLH,60,43,17,0.7166666666666667,No Limit Hold'em
3775,2/14/2023 7:00:00 pm,MGM Grand,89109,NLH,100,75,25,0.75,No Limit Hold'em
3776,2/14/2023 7:05:00 pm,The Orleans Casino,89103,NLH,100,76,24,0.76,Super Stack No-Limit Hold'em
3777,2/14/2023 8:00:00 pm,Horseshoe Las Vegas,89109,NLH,75,50,25,0.6666666666666666,No Limit Hold'em
3778,2/14/2023 9:00:00 pm,Caesars Palace,89109,NLH,150,115,35,0.7666666666666667,No Limit Hold'em
3779,2/14/2023 10:05:00 pm,South Point Casino,89183,NLH,60,47,13,0.7833333333333333,No Limit Hold'em Turbo
3780,2/14/2023 11:00:00 pm,Horseshoe Las Vegas,89109,NLH,75,50,25,0.6666666666666666,No Limit Hold'em
3781,2/14/2023 11:59:00 pm,MGM Grand,89109,NLH,100,75,25,0.75,Midnight Maddness Hyper Turbo
3782,2/15/2023 12:00:00 am,Caesars Palace,89109,NLH,100,75,25,0.75,No Limit Hold'em
3783,2/15/2023 9:00:00 am,Horseshoe Las Vegas,89109,NLH,75,50,25,0.6666666666666666,No Limit Hold'em
3784,2/15/2023 10:00:00 am,Caesars Palace,89109,NLH,100,75,25,0.75,No Limit Hold'em
3785,2/15/2023 10:05:00 am,South Point Casino,89183,NLH,60,43,17,0.7166666666666667,No Limit Hold'em
3786,2/15/2023 11:00:00 am,Horseshoe Las Vegas,89109,NLH,75,50,25,0.6666666666666666,No Limit Hold'em
3787,2/15/2023 11:00:00 am,MGM Grand,89109,NLH,100,75,25,0.75,No Limit Hold'em
3788,2/15/2023 11:05:00 am,The Orleans Casino,89103,NLH,100,76,24,0.76,Super Stack No-Limit Hold'em
3789,2/15/2023 12:00:00 pm,Wynn Casino,89109,NLH,200,165,35,0.825,No Limit Hold'em
3790,2/15/2023 1:00:00 pm,Aria Casino,89158,NLH,160,125,35,0.78125,No Limit Hold'em
3791,2/15/2023 2:00:00 pm,Horseshoe Las Vegas,89109,NLH,75,50,25,0.6666666666666666,No Limit Hold'em
3792,2/15/2023 2:00:00 pm,Caesars Palace,89109,NLH,150,115,35,0.7666666666666667,No Limit Hold'em
3793,2/15/2023 2:00:00 pm,MGM Grand,89109,NLH,100,75,25,0.75,No Limit Hold'em Turbo
3794,2/15/2023 2:05:00 pm,South Point Casino,89183,NLH,60,43,17,0.7166666666666667,No Limit Hold'em Turbo
3795,2/15/2023 4:05:00 pm,The Orleans Casino,89103,O8/S8,150,118,32,0.7866666666666666,Omaha 8/B / Stud 8
3796,2/15/2023 5:00:00 pm,Horseshoe Las Vegas,89109,NLH,75,50,25,0.6666666666666666,No Limit Hold'em
3797,2/15/2023 5:00:00 pm,Bellagio Casino,89109,NLH,160,125,35,0.78125,No Limit Hold'em
3798,2/15/2023 6:00:00 pm,Caesars Palace,89109,NLH,100,75,25,0.75,No Limit Hold'em
3799,2/15/2023 6:05:00 pm,South Point Casino,89183,NLH,150,118,32,0.7866666666666666,No Limit Hold'em Deep Stack
3800,2/15/2023 7:00:00 pm,MGM Grand,89109,NLH,100,75,25,0.75,No Limit Hold'em
3801,2/15/2023 7:05:00 pm,The Orleans Casino,89103,NLH,125,100,25,0.8,No Limit Hold'em Survivor
3802,2/15/2023 8:00:00 pm,Horseshoe Las Vegas,89109,NLH,75,50,25,0.6666666666666666,No Limit Hold'em
3803,2/15/2023 9:00:00 pm,Caesars Palace,89109,NLH,150,115,35,0.7666666666666667,No Limit Hold'em
3804,2/15/2023 10:05:00 pm,South Point Casino,89183,NLH,60,47,13,0.7833333333333333,No Limit Hold'em Turbo
3805,2/15/2023 11:00:00 pm,Horseshoe Las Vegas,89109,NLH,75,50,25,0.6666666666666666,No Limit Hold'em
3806,2/15/2023 11:59:00 pm,MGM Grand,89109,NLH,100,75,25,0.75,Midnight Maddness Hyper Turbo
3807,2/16/2023 12:00:00 am,Caesars Palace,89109,NLH,100,75,25,0.75,No Limit Hold'em
3808,2/16/2023 9:00:00 am,Horseshoe Las Vegas,89109,NLH,75,50,25,0.6666666666666666,No Limit Hold'em
3809,2/16/2023 10:00:00 am,Caesars Palace,89109,NLH,100,75,25,0.75,No Limit Hold'em
3810,2/16/2023 10:05:00 am,South Point Casino,89183,NLH,60,43,17,0.7166666666666667,No Limit Hold'em
3811,2/16/2023 11:00:00 am,Horseshoe Las Vegas,89109,NLH,75,50,25,0.6666666666666666,No Limit Hold'em
3812,2/16/2023 11:00:00 am,MGM Grand,89109,NLH,100,75,25,0.75,No Limit Hold'em
3813,2/16/2023 11:05:00 am,The Orleans Casino,89103,NLH,100,76,24,0.76,Super Stack No-Limit Hold'em
3814,2/16/2023 12:00:00 pm,Wynn Casino,89109,NLH,200,165,35,0.825,No Limit Hold'em
3815,2/16/2023 1:00:00 pm,Aria Casino,89158,NLH,160,125,35,0.78125,No Limit Hold'em
3816,2/16/2023 2:00:00 pm,Horseshoe Las Vegas,89109,NLH,75,50,25,0.6666666666666666,No Limit Hold'em
3817,2/16/2023 2:00:00 pm,Caesars Palace,89109,NLH,150,115,35,0.7666666666666667,No Limit Hold'em
3818,2/16/2023 2:00:00 pm,MGM Grand,89109,NLH,100,75,25,0.75,No Limit Hold'em Turbo
3819,2/16/2023 2:00:00 pm,South Point Casino,89183,O8/S8,150,118,32,0.7866666666666666,Omaha 8 / Stud 8
3820,2/16/2023 5:00:00 pm,Horseshoe Las Vegas,89109,NLH,75,50,25,0.6666666666666666,No Limit Hold'em
3821,2/16/2023 5:00:00 pm,Bellagio Casino,89109,NLH,160,125,35,0.78125,No Limit Hold'em
3822,2/16/2023 6:00:00 pm,Caesars Palace,89109,NLH,100,75,25,0.75,No Limit Hold'em
3823,2/16/2023 6:05:00 pm,South Point Casino,89183,NLH,60,43,17,0.7166666666666667,No Limit Hold'em
3824,2/16/2023 7:00:00 pm,MGM Grand,89109,NLH,100,75,25,0.75,No Limit Hold'em
3825,2/16/2023 7:05:00 pm,The Orleans Casino,89103,NLH,100,76,24,0.76,Super Stack No-Limit Hold'em
3826,2/16/2023 8:00:00 pm,Mandalay Bay,89119,NLH,60,40,20,0.6666666666666666,No Limit Hold'em
3827,2/16/2023 8:00:00 pm,Horseshoe Las Vegas,89109,NLH,75,50,25,0.6666666666666666,No Limit Hold'em
3828,2/16/2023 9:00:00 pm,Caesars Palace,89109,NLH,150,115,35,0.7666666666666667,No Limit Hold'em
3829,2/16/2023 10:05:00 pm,South Point Casino,89183,NLH,60,47,13,0.7833333333333333,No Limit Hold'em Turbo
3830,2/16/2023 11:00:00 pm,Horseshoe Las Vegas,89109,NLH,75,50,25,0.6666666666666666,No Limit Hold'em
3831,2/16/2023 11:59:00 pm,MGM Grand,89109,NLH,100,75,25,0.75,Midnight Maddness Hyper Turbo
3832,2/17/2023 12:00:00 am,Caesars Palace,89109,NLH,100,75,25,0.75,No Limit Hold'em
3833,2/17/2023 9:00:00 am,Horseshoe Las Vegas,89109,NLH,75,50,25,0.6666666666666666,No Limit Hold'em
3834,2/17/2023 10:00:00 am,Caesars Palace,89109,NLH,100,75,25,0.75,No Limit Hold'em
3835,2/17/2023 10:05:00 am,South Point Casino,89183,NLH,60,43,17,0.7166666666666667,No Limit Hold'em
3836,2/17/2023 11:00:00 am,Horseshoe Las Vegas,89109,NLH,75,50,25,0.6666666666666666,No Limit Hold'em
3837,2/17/2023 11:00:00 am,MGM Grand,89109,NLH,100,75,25,0.75,No Limit Hold'em
3838,2/17/2023 11:00:00 am,Wynn Casino,89109,NLH,230,190,40,0.8260869565217391,No Limit Hold'em
3839,2/17/2023 11:05:00 am,The Orleans Casino,89103,NLH,100,76,24,0.76,Super Stack No-Limit Hold'em
3840,2/17/2023 1:00:00 pm,Aria Casino,89158,NLH,240,195,45,0.8125,No Limit Hold'em
3841,2/17/2023 2:00:00 pm,Horseshoe Las Vegas,89109,NLH,75,50,25,0.6666666666666666,No Limit Hold'em
3842,2/17/2023 2:00:00 pm,Caesars Palace,89109,NLH,150,115,35,0.7666666666666667,No Limit Hold'em
3843,2/17/2023 2:00:00 pm,MGM Grand,89109,NLH,100,75,25,0.75,No Limit Hold'em Turbo
3844,2/17/2023 2:05:00 pm,South Point Casino,89183,NLH,60,43,17,0.7166666666666667,No Limit Hold'em Turbo
3845,2/17/2023 5:00:00 pm,Horseshoe Las Vegas,89109,NLH,75,50,25,0.6666666666666666,No Limit Hold'em
3846,2/17/2023 6:00:00 pm,Caesars Palace,89109,NLH,100,75,25,0.75,No Limit Hold'em
3847,2/17/2023 6:00:00 pm,South Point Casino,89183,NLH,150,118,32,0.7866666666666666,No Limit Hold'em Double Green Chip Bounty
3848,2/17/2023 6:30:00 pm,Poker Palace Casino,89030,NLH,20,10,10,0.5,No Limit Hold'em
3849,2/17/2023 7:00:00 pm,MGM Grand,89109,NLH,100,75,25,0.75,No Limit Hold'em
3850,2/17/2023 7:05:00 pm,The Orleans Casino,89103,NLH,150,118,32,0.7866666666666666,No-Limit Hold'em
3851,2/17/2023 8:00:00 pm,Mandalay Bay,89119,NLH,60,40,20,0.6666666666666666,No Limit Hold'em
3852,2/17/2023 8:00:00 pm,Horseshoe Las Vegas,89109,NLH,75,50,25,0.6666666666666666,No Limit Hold'em
3853,2/17/2023 9:00:00 pm,Caesars Palace,89109,NLH,150,115,35,0.7666666666666667,No Limit Hold'em
3854,2/17/2023 10:05:00 pm,South Point Casino,89183,NLH,60,47,13,0.7833333333333333,No Limit Hold'em Turbo
3855,2/17/2023 11:00:00 pm,Horseshoe Las Vegas,89109,NLH,75,50,25,0.6666666666666666,No Limit Hold'em
3856,2/17/2023 11:59:00 pm,MGM Grand,89109,NLH,100,75,25,0.75,Midnight Maddness Hyper Turbo
3857,2/18/2023 12:00:00 am,Caesars Palace,89109,NLH,100,75,25,0.75,No Limit Hold'em
3858,2/18/2023 9:00:00 am,Horseshoe Las Vegas,89109,NLH,75,50,25,0.6666666666666666,No Limit Hold'em
3859,2/18/2023 10:00:00 am,Caesars Palace,89109,NLH,100,75,25,0.75,No Limit Hold'em
3860,2/18/2023 10:05:00 am,South Point Casino,89183,NLH,60,43,17,0.7166666666666667,No Limit Hold'em
3861,2/18/2023 11:00:00 am,Horseshoe Las Vegas,89109,NLH,75,50,25,0.6666666666666666,No Limit Hold'em
3862,2/18/2023 11:00:00 am,MGM Grand,89109,NLH,100,75,25,0.75,No Limit Hold'em
3863,2/18/2023 11:00:00 am,Wynn Casino,89109,NLH,300,256,44,0.8533333333333334,No Limit Hold'em
3864,2/18/2023 11:05:00 am,The Orleans Casino,89103,NLH,400,338,62,0.845,No-Limit Hold'em Mardi Gras Bash
3865,2/18/2023 1:00:00 pm,Aria Casino,89158,NLH,240,195,45,0.8125,No Limit Hold'em
3866,2/18/2023 2:00:00 pm,Caesars Palace,89109,NLH,150,115,35,0.7666666666666667,No Limit Hold'em
3867,2/18/2023 2:00:00 pm,MGM Grand,89109,NLH,100,75,25,0.75,No Limit Hold'em Turbo
3868,2/18/2023 2:00:00 pm,Horseshoe Las Vegas,89109,NLH,160,115,45,0.71875,No Limit Hold'em Saturday
3869,2/18/2023 2:05:00 pm,South Point Casino,89183,NLH,60,43,17,0.7166666666666667,No Limit Hold'em Turbo
3870,2/18/2023 3:05:00 pm,Resorts World Las Vegas,89109,NLH,160,130,30,0.8125,LADIES NLH $160 $3K GTD BY PLON
3871,2/18/2023 4:00:00 pm,MGM Grand,89109,PLO,150,120,30,0.8,Double Board Bomb Pot PLO
3872,2/18/2023 5:00:00 pm,Horseshoe Las Vegas,89109,NLH,75,50,25,0.6666666666666666,No Limit Hold'em
3873,2/18/2023 6:00:00 pm,Caesars Palace,89109,NLH,100,75,25,0.75,No Limit Hold'em
3874,2/18/2023 6:05:00 pm,South Point Casino,89183,NLH,150,118,32,0.7866666666666666,No Limit Hold'em Deep Stack
3875,2/18/2023 6:30:00 pm,Poker Palace Casino,89030,NLH,20,10,10,0.5,No Limit Hold'em
3876,2/18/2023 7:00:00 pm,MGM Grand,89109,NLH,100,75,25,0.75,No Limit Hold'em
3877,2/18/2023 7:05:00 pm,The Orleans Casino,89103,NLH,220,188,32,0.8545454545454545,No Limit Hold'em Bounty
3878,2/18/2023 8:00:00 pm,Horseshoe Las Vegas,89109,NLH,75,50,25,0.6666666666666666,No Limit Hold'em
3879,2/18/2023 8:00:00 pm,Mandalay Bay,89119,NLH,150,125,25,0.8333333333333334,No Limit Hold'em Saturday Night Classic
3880,2/18/2023 9:00:00 pm,Caesars Palace,89109,NLH,150,115,35,0.7666666666666667,No Limit Hold'em
3881,2/18/2023 10:05:00 pm,South Point Casino,89183,NLH,60,47,13,0.7833333333333333,No Limit Hold'em Turbo
3882,2/18/2023 11:00:00 pm,Horseshoe Las Vegas,89109,NLH,75,50,25,0.6666666666666666,No Limit Hold'em
3883,2/18/2023 11:59:00 pm,MGM Grand,89109,NLH,100,75,25,0.75,Midnight Maddness Hyper Turbo
3884,2/19/2023 12:00:00 am,Caesars Palace,89109,NLH,100,75,25,0.75,No Limit Hold'em
3885,2/19/2023 9:00:00 am,Horseshoe Las Vegas,89109,NLH,75,50,25,0.6666666666666666,No Limit Hold'em
3886,2/19/2023 10:00:00 am,Caesars Palace,89109,NLH,100,75,25,0.75,No Limit Hold'em
3887,2/19/2023 10:05:00 am,South Point Casino,89183,NLH,60,43,17,0.7166666666666667,No Limit Hold'em
3888,2/19/2023 11:00:00 am,Horseshoe Las Vegas,89109,NLH,75,50,25,0.6666666666666666,No Limit Hold'em
3889,2/19/2023 11:00:00 am,MGM Grand,89109,NLH,100,75,25,0.75,No Limit Hold'em
3890,2/19/2023 11:05:00 am,The Orleans Casino,89103,NLH,200,148,52,0.74,Sunday Special No-Limit Hold'em
3891,2/19/2023 12:00:00 pm,Wynn Casino,89109,NLH,200,165,35,0.825,No Limit Hold'em
3892,2/19/2023 1:00:00 pm,Aria Casino,89158,NLH,160,125,35,0.78125,No Limit Hold'em
3893,2/19/2023 2:00:00 pm,Horseshoe Las Vegas,89109,NLH,75,50,25,0.6666666666666666,No Limit Hold'em
3894,2/19/2023 2:00:00 pm,Caesars Palace,89109,NLH,150,115,35,0.7666666666666667,No Limit Hold'em
3895,2/19/2023 2:00:00 pm,MGM Grand,89109,NLH,100,75,25,0.75,No Limit Hold'em Turbo
3896,2/19/2023 4:05:00 pm,The Orleans Casino,89103,ROSE,200,158,42,0.79,R.O.S.E.
3897,2/19/2023 5:00:00 pm,Horseshoe Las Vegas,89109,NLH,75,50,25,0.6666666666666666,No Limit Hold'em
3898,2/19/2023 5:00:00 pm,Bellagio Casino,89109,NLH,160,125,35,0.78125,No Limit Hold'em
3899,2/19/2023 6:00:00 pm,Caesars Palace,89109,NLH,100,75,25,0.75,No Limit Hold'em
3900,2/19/2023 6:05:00 pm,South Point Casino,89183,NLH,150,118,32,0.7866666666666666,No Limit Hold'em Deep Stack
3901,2/19/2023 7:00:00 pm,MGM Grand,89109,NLH,100,75,25,0.75,No Limit Hold'em
3902,2/19/2023 8:00:00 pm,Mandalay Bay,89119,NLH,60,40,20,0.6666666666666666,No Limit Hold'em
3903,2/19/2023 8:00:00 pm,Horseshoe Las Vegas,89109,NLH,75,50,25,0.6666666666666666,No Limit Hold'em
3904,2/19/2023 9:00:00 pm,Caesars Palace,89109,NLH,150,115,35,0.7666666666666667,No Limit Hold'em
3905,2/19/2023 10:05:00 pm,South Point Casino,89183,NLH,60,47,13,0.7833333333333333,No Limit Hold'em Turbo
3906,2/19/2023 11:00:00 pm,Horseshoe Las Vegas,89109,NLH,75,50,25,0.6666666666666666,No Limit Hold'em
3907,2/19/2023 11:59:00 pm,MGM Grand,89109,NLH,100,75,25,0.75,Midnight Maddness Hyper Turbo
3908,2/20/2023 12:00:00 am,Caesars Palace,89109,NLH,100,75,25,0.75,No Limit Hold'em
3909,2/20/2023 9:00:00 am,Horseshoe Las Vegas,89109,NLH,75,50,25,0.6666666666666666,No Limit Hold'em
3910,2/20/2023 10:00:00 am,Caesars Palace,89109,NLH,100,75,25,0.75,No Limit Hold'em
3911,2/20/2023 10:05:00 am,South Point Casino,89183,NLH,60,43,17,0.7166666666666667,No Limit Hold'em
3912,2/20/2023 11:00:00 am,Horseshoe Las Vegas,89109,NLH,75,50,25,0.6666666666666666,No Limit Hold'em
3913,2/20/2023 11:00:00 am,MGM Grand,89109,NLH,100,75,25,0.75,No Limit Hold'em
3914,2/20/2023 11:05:00 am,The Orleans Casino,89103,NLH,100,76,24,0.76,Super Stack No-Limit Hold'em
3915,2/20/2023 12:00:00 pm,Wynn Casino,89109,NLH,200,165,35,0.825,No Limit Hold'em
3916,2/20/2023 1:00:00 pm,Aria Casino,89158,NLH,160,125,35,0.78125,No Limit Hold'em
3917,2/20/2023 2:00:00 pm,Horseshoe Las Vegas,89109,NLH,75,50,25,0.6666666666666666,No Limit Hold'em
3918,2/20/2023 2:00:00 pm,Caesars Palace,89109,NLH,150,115,35,0.7666666666666667,No Limit Hold'em
3919,2/20/2023 2:00:00 pm,MGM Grand,89109,NLH,100,75,25,0.75,No Limit Hold'em Turbo
3920,2/20/2023 2:05:00 pm,South Point Casino,89183,NLH,60,43,17,0.7166666666666667,No Limit Hold'em Turbo
3921,2/20/2023 4:05:00 pm,The Orleans Casino,89103,HORSE,125,98,27,0.784,H.O.R.S.E.
3922,2/20/2023 5:00:00 pm,Horseshoe Las Vegas,89109,NLH,75,50,25,0.6666666666666666,No Limit Hold'em
3923,2/20/2023 5:00:00 pm,Bellagio Casino,89109,NLH,160,125,35,0.78125,No Limit Hold'em
3924,2/20/2023 6:00:00 pm,Caesars Palace,89109,NLH,100,75,25,0.75,No Limit Hold'em
3925,2/20/2023 6:05:00 pm,South Point Casino,89183,NLH,60,43,17,0.7166666666666667,No Limit Hold'em
3926,2/20/2023 7:00:00 pm,MGM Grand,89109,NLH,100,75,25,0.75,No Limit Hold'em
3927,2/20/2023 7:05:00 pm,The Orleans Casino,89103,NLH,125,98,27,0.784,No Limit Crazy Pineapple
3928,2/20/2023 8:00:00 pm,Mandalay Bay,89119,NLH,60,40,20,0.6666666666666666,No Limit Hold'em
3929,2/20/2023 8:00:00 pm,Horseshoe Las Vegas,89109,NLH,75,50,25,0.6666666666666666,No Limit Hold'em
3930,2/20/2023 9:00:00 pm,Caesars Palace,89109,NLH,150,115,35,0.7666666666666667,No Limit Hold'em
3931,2/20/2023 10:05:00 pm,South Point Casino,89183,NLH,60,47,13,0.7833333333333333,No Limit Hold'em Turbo
3932,2/20/2023 11:00:00 pm,Horseshoe Las Vegas,89109,NLH,75,50,25,0.6666666666666666,No Limit Hold'em
3933,2/20/2023 11:59:00 pm,MGM Grand,89109,NLH,100,75,25,0.75,Midnight Maddness Hyper Turbo
3934,2/21/2023 12:00:00 am,Caesars Palace,89109,NLH,100,75,25,0.75,No Limit Hold'em
3935,2/21/2023 9:00:00 am,Horseshoe Las Vegas,89109,NLH,75,50,25,0.6666666666666666,No Limit Hold'em
3936,2/21/2023 10:00:00 am,Caesars Palace,89109,NLH,100,75,25,0.75,No Limit Hold'em
3937,2/21/2023 10:05:00 am,South Point Casino,89183,NLH,60,43,17,0.7166666666666667,No Limit Hold'em
3938,2/21/2023 11:00:00 am,Horseshoe Las Vegas,89109,NLH,75,50,25,0.6666666666666666,No Limit Hold'em
3939,2/21/2023 11:00:00 am,MGM Grand,89109,NLH,100,75,25,0.75,No Limit Hold'em
3940,2/21/2023 11:05:00 am,The Orleans Casino,89103,NLH,100,76,24,0.76,Super Stack No-Limit Hold'em
3941,2/21/2023 12:00:00 pm,Wynn Casino,89109,NLH,200,165,35,0.825,No Limit Hold'em
3942,2/21/2023 1:00:00 pm,Aria Casino,89158,NLH,160,125,35,0.78125,No Limit Hold'em
3943,2/21/2023 2:00:00 pm,Horseshoe Las Vegas,89109,NLH,75,50,25,0.6666666666666666,No Limit Hold'em
3944,2/21/2023 2:00:00 pm,Caesars Palace,89109,NLH,150,115,35,0.7666666666666667,No Limit Hold'em
3945,2/21/2023 2:00:00 pm,MGM Grand,89109,NLH,100,75,25,0.75,No Limit Hold'em Turbo
3946,2/21/2023 2:05:00 pm,South Point Casino,89183,FLO8,60,43,17,0.7166666666666667,Omaha 8/B
3947,2/21/2023 5:00:00 pm,Horseshoe Las Vegas,89109,NLH,75,50,25,0.6666666666666666,No Limit Hold'em
3948,2/21/2023 5:00:00 pm,Bellagio Casino,89109,NLH,160,125,35,0.78125,No Limit Hold'em
3949,2/21/2023 6:00:00 pm,Caesars Palace,89109,NLH,100,75,25,0.75,No Limit Hold'em
3950,2/21/2023 6:05:00 pm,South Point Casino,89183,NLH,60,43,17,0.7166666666666667,No Limit Hold'em
3951,2/21/2023 7:00:00 pm,MGM Grand,89109,NLH,100,75,25,0.75,No Limit Hold'em
3952,2/21/2023 7:05:00 pm,The Orleans Casino,89103,NLH,100,76,24,0.76,Super Stack No-Limit Hold'em
3953,2/21/2023 8:00:00 pm,Horseshoe Las Vegas,89109,NLH,75,50,25,0.6666666666666666,No Limit Hold'em
3954,2/21/2023 9:00:00 pm,Caesars Palace,89109,NLH,150,115,35,0.7666666666666667,No Limit Hold'em
3955,2/21/2023 10:05:00 pm,South Point Casino,89183,NLH,60,47,13,0.7833333333333333,No Limit Hold'em Turbo
3956,2/21/2023 11:00:00 pm,Horseshoe Las Vegas,89109,NLH,75,50,25,0.6666666666666666,No Limit Hold'em
3957,2/21/2023 11:59:00 pm,MGM Grand,89109,NLH,100,75,25,0.75,Midnight Maddness Hyper Turbo
3958,2/22/2023 12:00:00 am,Caesars Palace,89109,NLH,100,75,25,0.75,No Limit Hold'em
3959,2/22/2023 9:00:00 am,Horseshoe Las Vegas,89109,NLH,75,50,25,0.6666666666666666,No Limit Hold'em
3960,2/22/2023 10:00:00 am,Caesars Palace,89109,NLH,100,75,25,0.75,No Limit Hold'em
3961,2/22/2023 10:05:00 am,South Point Casino,89183,NLH,60,43,17,0.7166666666666667,No Limit Hold'em
3962,2/22/2023 11:00:00 am,Horseshoe Las Vegas,89109,NLH,75,50,25,0.6666666666666666,No Limit Hold'em
3963,2/22/2023 11:00:00 am,MGM Grand,89109,NLH,100,75,25,0.75,No Limit Hold'em
3964,2/22/2023 11:05:00 am,The Orleans Casino,89103,NLH,100,76,24,0.76,Super Stack No-Limit Hold'em
3965,2/22/2023 12:00:00 pm,Wynn Casino,89109,NLH,200,165,35,0.825,No Limit Hold'em
3966,2/22/2023 1:00:00 pm,Aria Casino,89158,NLH,160,125,35,0.78125,No Limit Hold'em
3967,2/22/2023 2:00:00 pm,Horseshoe Las Vegas,89109,NLH,75,50,25,0.6666666666666666,No Limit Hold'em
3968,2/22/2023 2:00:00 pm,Caesars Palace,89109,NLH,150,115,35,0.7666666666666667,No Limit Hold'em
3969,2/22/2023 2:00:00 pm,MGM Grand,89109,NLH,100,75,25,0.75,No Limit Hold'em Turbo
3970,2/22/2023 2:05:00 pm,South Point Casino,89183,NLH,60,43,17,0.7166666666666667,No Limit Hold'em Turbo
3971,2/22/2023 4:05:00 pm,The Orleans Casino,89103,O8/S8,150,118,32,0.7866666666666666,Omaha 8/B / Stud 8
3972,2/22/2023 5:00:00 pm,Horseshoe Las Vegas,89109,NLH,75,50,25,0.6666666666666666,No Limit Hold'em
3973,2/22/2023 5:00:00 pm,Bellagio Casino,89109,NLH,160,125,35,0.78125,No Limit Hold'em
3974,2/22/2023 6:00:00 pm,Caesars Palace,89109,NLH,100,75,25,0.75,No Limit Hold'em
3975,2/22/2023 6:05:00 pm,South Point Casino,89183,NLH,150,118,32,0.7866666666666666,No Limit Hold'em Deep Stack
3976,2/22/2023 7:00:00 pm,MGM Grand,89109,NLH,100,75,25,0.75,No Limit Hold'em
3977,2/22/2023 7:05:00 pm,The Orleans Casino,89103,NLH,125,100,25,0.8,No Limit Hold'em Survivor
3978,2/22/2023 8:00:00 pm,Horseshoe Las Vegas,89109,NLH,75,50,25,0.6666666666666666,No Limit Hold'em
3979,2/22/2023 9:00:00 pm,Caesars Palace,89109,NLH,150,115,35,0.7666666666666667,No Limit Hold'em
3980,2/22/2023 10:05:00 pm,South Point Casino,89183,NLH,60,47,13,0.7833333333333333,No Limit Hold'em Turbo
3981,2/22/2023 11:00:00 pm,Horseshoe Las Vegas,89109,NLH,75,50,25,0.6666666666666666,No Limit Hold'em
3982,2/22/2023 11:59:00 pm,MGM Grand,89109,NLH,100,75,25,0.75,Midnight Maddness Hyper Turbo
3983,2/23/2023 12:00:00 am,Caesars Palace,89109,NLH,100,75,25,0.75,No Limit Hold'em
3984,2/23/2023 9:00:00 am,Horseshoe Las Vegas,89109,NLH,75,50,25,0.6666666666666666,No Limit Hold'em
3985,2/23/2023 10:00:00 am,Caesars Palace,89109,NLH,100,75,25,0.75,No Limit Hold'em
3986,2/23/2023 10:05:00 am,South Point Casino,89183,NLH,60,43,17,0.7166666666666667,No Limit Hold'em
3987,2/23/2023 11:00:00 am,Horseshoe Las Vegas,89109,NLH,75,50,25,0.6666666666666666,No Limit Hold'em
3988,2/23/2023 11:00:00 am,MGM Grand,89109,NLH,100,75,25,0.75,No Limit Hold'em
3989,2/23/2023 11:05:00 am,The Orleans Casino,89103,NLH,100,76,24,0.76,Super Stack No-Limit Hold'em
3990,2/23/2023 12:00:00 pm,Wynn Casino,89109,NLH,200,165,35,0.825,No Limit Hold'em
3991,2/23/2023 1:00:00 pm,Aria Casino,89158,NLH,160,125,35,0.78125,No Limit Hold'em
3992,2/23/2023 2:00:00 pm,Horseshoe Las Vegas,89109,NLH,75,50,25,0.6666666666666666,No Limit Hold'em
3993,2/23/2023 2:00:00 pm,Caesars Palace,89109,NLH,150,115,35,0.7666666666666667,No Limit Hold'em
3994,2/23/2023 2:00:00 pm,MGM Grand,89109,NLH,100,75,25,0.75,No Limit Hold'em Turbo
3995,2/23/2023 2:00:00 pm,South Point Casino,89183,O8/S8,150,118,32,0.7866666666666666,Omaha 8 / Stud 8
3996,2/23/2023 5:00:00 pm,Horseshoe Las Vegas,89109,NLH,75,50,25,0.6666666666666666,No Limit Hold'em
3997,2/23/2023 5:00:00 pm,Bellagio Casino,89109,NLH,160,125,35,0.78125,No Limit Hold'em
3998,2/23/2023 6:00:00 pm,Caesars Palace,89109,NLH,100,75,25,0.75,No Limit Hold'em
3999,2/23/2023 6:05:00 pm,South Point Casino,89183,NLH,60,43,17,0.7166666666666667,No Limit Hold'em
4000,2/23/2023 7:00:00 pm,MGM Grand,89109,NLH,100,75,25,0.75,No Limit Hold'em
4001,2/23/2023 7:05:00 pm,The Orleans Casino,89103,NLH,100,76,24,0.76,Super Stack No-Limit Hold'em
4002,2/23/2023 8:00:00 pm,Mandalay Bay,89119,NLH,60,40,20,0.6666666666666666,No Limit Hold'em
4003,2/23/2023 8:00:00 pm,Horseshoe Las Vegas,89109,NLH,75,50,25,0.6666666666666666,No Limit Hold'em
4004,2/23/2023 9:00:00 pm,Caesars Palace,89109,NLH,150,115,35,0.7666666666666667,No Limit Hold'em
4005,2/23/2023 10:05:00 pm,South Point Casino,89183,NLH,60,47,13,0.7833333333333333,No Limit Hold'em Turbo
4006,2/23/2023 11:00:00 pm,Horseshoe Las Vegas,89109,NLH,75,50,25,0.6666666666666666,No Limit Hold'em
4007,2/23/2023 11:59:00 pm,MGM Grand,89109,NLH,100,75,25,0.75,Midnight Maddness Hyper Turbo
4008,2/24/2023 12:00:00 am,Caesars Palace,89109,NLH,100,75,25,0.75,No Limit Hold'em
4009,2/24/2023 9:00:00 am,Horseshoe Las Vegas,89109,NLH,75,50,25,0.6666666666666666,No Limit Hold'em
4010,2/24/2023 10:00:00 am,Caesars Palace,89109,NLH,100,75,25,0.75,No Limit Hold'em
4011,2/24/2023 10:05:00 am,South Point Casino,89183,NLH,60,43,17,0.7166666666666667,No Limit Hold'em
4012,2/24/2023 11:00:00 am,Horseshoe Las Vegas,89109,NLH,75,50,25,0.6666666666666666,No Limit Hold'em
4013,2/24/2023 11:00:00 am,MGM Grand,89109,NLH,100,75,25,0.75,No Limit Hold'em
4014,2/24/2023 11:00:00 am,Wynn Casino,89109,NLH,230,190,40,0.8260869565217391,No Limit Hold'em
4015,2/24/2023 11:05:00 am,The Orleans Casino,89103,NLH,100,76,24,0.76,Super Stack No-Limit Hold'em
4016,2/24/2023 1:00:00 pm,Aria Casino,89158,NLH,240,195,45,0.8125,No Limit Hold'em
4017,2/24/2023 2:00:00 pm,Horseshoe Las Vegas,89109,NLH,75,50,25,0.6666666666666666,No Limit Hold'em
4018,2/24/2023 2:00:00 pm,Caesars Palace,89109,NLH,150,115,35,0.7666666666666667,No Limit Hold'em
4019,2/24/2023 2:00:00 pm,MGM Grand,89109,NLH,100,75,25,0.75,No Limit Hold'em Turbo
4020,2/24/2023 2:05:00 pm,South Point Casino,89183,NLH,60,43,17,0.7166666666666667,No Limit Hold'em Turbo
4021,2/24/2023 5:00:00 pm,Horseshoe Las Vegas,89109,NLH,75,50,25,0.6666666666666666,No Limit Hold'em
4022,2/24/2023 6:00:00 pm,Caesars Palace,89109,NLH,100,75,25,0.75,No Limit Hold'em
4023,2/24/2023 6:00:00 pm,South Point Casino,89183,NLH,150,118,32,0.7866666666666666,No Limit Hold'em Double Green Chip Bounty
4024,2/24/2023 6:30:00 pm,Poker Palace Casino,89030,NLH,20,10,10,0.5,No Limit Hold'em
4025,2/24/2023 7:00:00 pm,MGM Grand,89109,NLH,100,75,25,0.75,No Limit Hold'em
4026,2/24/2023 7:05:00 pm,The Orleans Casino,89103,NLH,150,118,32,0.7866666666666666,No-Limit Hold'em
4027,2/24/2023 8:00:00 pm,Mandalay Bay,89119,NLH,60,40,20,0.6666666666666666,No Limit Hold'em
4028,2/24/2023 8:00:00 pm,Horseshoe Las Vegas,89109,NLH,75,50,25,0.6666666666666666,No Limit Hold'em
4029,2/24/2023 9:00:00 pm,Caesars Palace,89109,NLH,150,115,35,0.7666666666666667,No Limit Hold'em
4030,2/24/2023 10:05:00 pm,South Point Casino,89183,NLH,60,47,13,0.7833333333333333,No Limit Hold'em Turbo
4031,2/24/2023 11:00:00 pm,Horseshoe Las Vegas,89109,NLH,75,50,25,0.6666666666666666,No Limit Hold'em
4032,2/24/2023 11:59:00 pm,MGM Grand,89109,NLH,100,75,25,0.75,Midnight Maddness Hyper Turbo
4033,2/25/2023 12:00:00 am,Caesars Palace,89109,NLH,100,75,25,0.75,No Limit Hold'em
4034,2/25/2023 9:00:00 am,Horseshoe Las Vegas,89109,NLH,75,50,25,0.6666666666666666,No Limit Hold'em
4035,2/25/2023 10:00:00 am,Caesars Palace,89109,NLH,100,75,25,0.75,No Limit Hold'em
4036,2/25/2023 10:05:00 am,South Point Casino,89183,NLH,60,43,17,0.7166666666666667,No Limit Hold'em
4037,2/25/2023 11:00:00 am,Horseshoe Las Vegas,89109,NLH,75,50,25,0.6666666666666666,No Limit Hold'em
4038,2/25/2023 11:00:00 am,MGM Grand,89109,NLH,100,75,25,0.75,No Limit Hold'em
4039,2/25/2023 11:00:00 am,Wynn Casino,89109,NLH,300,256,44,0.8533333333333334,No Limit Hold'em
4040,2/25/2023 11:05:00 am,The Orleans Casino,89103,NLH,150,118,32,0.7866666666666666,No-Limit Hold'em Monster Stack
4041,2/25/2023 1:00:00 pm,Aria Casino,89158,NLH,240,195,45,0.8125,No Limit Hold'em
4042,2/25/2023 2:00:00 pm,Caesars Palace,89109,NLH,150,115,35,0.7666666666666667,No Limit Hold'em
4043,2/25/2023 2:00:00 pm,MGM Grand,89109,NLH,100,75,25,0.75,No Limit Hold'em Turbo
4044,2/25/2023 2:00:00 pm,Horseshoe Las Vegas,89109,NLH,160,115,45,0.71875,No Limit Hold'em Saturday
4045,2/25/2023 2:05:00 pm,South Point Casino,89183,NLH,60,43,17,0.7166666666666667,No Limit Hold'em Turbo
4046,2/25/2023 4:00:00 pm,MGM Grand,89109,PLO,150,120,30,0.8,Double Board Bomb Pot PLO
4047,2/25/2023 5:00:00 pm,Horseshoe Las Vegas,89109,NLH,75,50,25,0.6666666666666666,No Limit Hold'em
4048,2/25/2023 6:00:00 pm,Caesars Palace,89109,NLH,100,75,25,0.75,No Limit Hold'em
4049,2/25/2023 6:05:00 pm,South Point Casino,89183,NLH,150,118,32,0.7866666666666666,No Limit Hold'em Deep Stack
4050,2/25/2023 6:30:00 pm,Poker Palace Casino,89030,NLH,20,10,10,0.5,No Limit Hold'em
4051,2/25/2023 7:00:00 pm,MGM Grand,89109,NLH,100,75,25,0.75,No Limit Hold'em
4052,2/25/2023 7:05:00 pm,The Orleans Casino,89103,NLH,220,188,32,0.8545454545454545,No Limit Hold'em Bounty
4053,2/25/2023 8:00:00 pm,Horseshoe Las Vegas,89109,NLH,75,50,25,0.6666666666666666,No Limit Hold'em
4054,2/25/2023 8:00:00 pm,Mandalay Bay,89119,NLH,150,125,25,0.8333333333333334,No Limit Hold'em Saturday Night Classic
4055,2/25/2023 9:00:00 pm,Caesars Palace,89109,NLH,150,115,35,0.7666666666666667,No Limit Hold'em
4056,2/25/2023 10:05:00 pm,South Point Casino,89183,NLH,60,47,13,0.7833333333333333,No Limit Hold'em Turbo
4057,2/25/2023 11:00:00 pm,Horseshoe Las Vegas,89109,NLH,75,50,25,0.6666666666666666,No Limit Hold'em
4058,2/25/2023 11:59:00 pm,MGM Grand,89109,NLH,100,75,25,0.75,Midnight Maddness Hyper Turbo
4059,2/26/2023 12:00:00 am,Caesars Palace,89109,NLH,100,75,25,0.75,No Limit Hold'em
4060,2/26/2023 9:00:00 am,Horseshoe Las Vegas,89109,NLH,75,50,25,0.6666666666666666,No Limit Hold'em
4061,2/26/2023 10:00:00 am,Caesars Palace,89109,NLH,100,75,25,0.75,No Limit Hold'em
4062,2/26/2023 10:05:00 am,South Point Casino,89183,NLH,60,43,17,0.7166666666666667,No Limit Hold'em
4063,2/26/2023 11:00:00 am,Horseshoe Las Vegas,89109,NLH,75,50,25,0.6666666666666666,No Limit Hold'em
4064,2/26/2023 11:00:00 am,MGM Grand,89109,NLH,100,75,25,0.75,No Limit Hold'em
4065,2/26/2023 12:00:00 pm,Wynn Casino,89109,NLH,200,165,35,0.825,No Limit Hold'em
4066,2/26/2023 1:00:00 pm,Aria Casino,89158,NLH,160,125,35,0.78125,No Limit Hold'em
4067,2/26/2023 2:00:00 pm,Horseshoe Las Vegas,89109,NLH,75,50,25,0.6666666666666666,No Limit Hold'em
4068,2/26/2023 2:00:00 pm,Caesars Palace,89109,NLH,150,115,35,0.7666666666666667,No Limit Hold'em
4069,2/26/2023 2:00:00 pm,MGM Grand,89109,NLH,100,75,25,0.75,No Limit Hold'em Turbo
4070,2/26/2023 5:00:00 pm,Horseshoe Las Vegas,89109,NLH,75,50,25,0.6666666666666666,No Limit Hold'em
4071,2/26/2023 5:00:00 pm,Bellagio Casino,89109,NLH,160,125,35,0.78125,No Limit Hold'em
4072,2/26/2023 6:00:00 pm,Caesars Palace,89109,NLH,100,75,25,0.75,No Limit Hold'em
4073,2/26/2023 6:05:00 pm,South Point Casino,89183,NLH,150,118,32,0.7866666666666666,No Limit Hold'em Deep Stack
4074,2/26/2023 7:00:00 pm,MGM Grand,89109,NLH,100,75,25,0.75,No Limit Hold'em
4075,2/26/2023 8:00:00 pm,Mandalay Bay,89119,NLH,60,40,20,0.6666666666666666,No Limit Hold'em
4076,2/26/2023 8:00:00 pm,Horseshoe Las Vegas,89109,NLH,75,50,25,0.6666666666666666,No Limit Hold'em
4077,2/26/2023 9:00:00 pm,Caesars Palace,89109,NLH,150,115,35,0.7666666666666667,No Limit Hold'em
4078,2/26/2023 10:05:00 pm,South Point Casino,89183,NLH,60,47,13,0.7833333333333333,No Limit Hold'em Turbo
4079,2/26/2023 11:00:00 pm,Horseshoe Las Vegas,89109,NLH,75,50,25,0.6666666666666666,No Limit Hold'em
4080,2/26/2023 11:59:00 pm,MGM Grand,89109,NLH,100,75,25,0.75,Midnight Maddness Hyper Turbo
4081,2/27/2023 12:00:00 am,Caesars Palace,89109,NLH,100,75,25,0.75,No Limit Hold'em
4082,2/27/2023 9:00:00 am,Horseshoe Las Vegas,89109,NLH,75,50,25,0.6666666666666666,No Limit Hold'em
4083,2/27/2023 10:00:00 am,Caesars Palace,89109,NLH,100,75,25,0.75,No Limit Hold'em
4084,2/27/2023 10:05:00 am,South Point Casino,89183,NLH,60,43,17,0.7166666666666667,No Limit Hold'em
4085,2/27/2023 11:00:00 am,Horseshoe Las Vegas,89109,NLH,75,50,25,0.6666666666666666,No Limit Hold'em
4086,2/27/2023 11:00:00 am,MGM Grand,89109,NLH,100,75,25,0.75,No Limit Hold'em
4087,2/27/2023 11:05:00 am,The Orleans Casino,89103,NLH,100,76,24,0.76,Super Stack No-Limit Hold'em
4088,2/27/2023 12:00:00 pm,Wynn Casino,89109,NLH,200,165,35,0.825,No Limit Hold'em
4089,2/27/2023 1:00:00 pm,Aria Casino,89158,NLH,160,125,35,0.78125,No Limit Hold'em
4090,2/27/2023 2:00:00 pm,Horseshoe Las Vegas,89109,NLH,75,50,25,0.6666666666666666,No Limit Hold'em
4091,2/27/2023 2:00:00 pm,Caesars Palace,89109,NLH,150,115,35,0.7666666666666667,No Limit Hold'em
4092,2/27/2023 2:00:00 pm,MGM Grand,89109,NLH,100,75,25,0.75,No Limit Hold'em Turbo
4093,2/27/2023 2:05:00 pm,South Point Casino,89183,NLH,60,43,17,0.7166666666666667,No Limit Hold'em Turbo
4094,2/27/2023 4:05:00 pm,The Orleans Casino,89103,HORSE,125,98,27,0.784,H.O.R.S.E.
4095,2/27/2023 5:00:00 pm,Horseshoe Las Vegas,89109,NLH,75,50,25,0.6666666666666666,No Limit Hold'em
4096,2/27/2023 5:00:00 pm,Bellagio Casino,89109,NLH,160,125,35,0.78125,No Limit Hold'em
4097,2/27/2023 6:00:00 pm,Caesars Palace,89109,NLH,100,75,25,0.75,No Limit Hold'em
4098,2/27/2023 6:05:00 pm,South Point Casino,89183,NLH,60,43,17,0.7166666666666667,No Limit Hold'em
4099,2/27/2023 7:00:00 pm,MGM Grand,89109,NLH,100,75,25,0.75,No Limit Hold'em
4100,2/27/2023 7:05:00 pm,The Orleans Casino,89103,NLH,125,98,27,0.784,No Limit Crazy Pineapple
4101,2/27/2023 8:00:00 pm,Mandalay Bay,89119,NLH,60,40,20,0.6666666666666666,No Limit Hold'em
4102,2/27/2023 8:00:00 pm,Horseshoe Las Vegas,89109,NLH,75,50,25,0.6666666666666666,No Limit Hold'em
4103,2/27/2023 9:00:00 pm,Caesars Palace,89109,NLH,150,115,35,0.7666666666666667,No Limit Hold'em
4104,2/27/2023 10:05:00 pm,South Point Casino,89183,NLH,60,47,13,0.7833333333333333,No Limit Hold'em Turbo
4105,2/27/2023 11:00:00 pm,Horseshoe Las Vegas,89109,NLH,75,50,25,0.6666666666666666,No Limit Hold'em
4106,2/27/2023 11:59:00 pm,MGM Grand,89109,NLH,100,75,25,0.75,Midnight Maddness Hyper Turbo
4107,2/28/2023 12:00:00 am,Caesars Palace,89109,NLH,100,75,25,0.75,No Limit Hold'em
4108,2/28/2023 9:00:00 am,Horseshoe Las Vegas,89109,NLH,75,50,25,0.6666666666666666,No Limit Hold'em
4109,2/28/2023 10:00:00 am,Caesars Palace,89109,NLH,100,75,25,0.75,No Limit Hold'em
4110,2/28/2023 10:05:00 am,South Point Casino,89183,NLH,60,43,17,0.7166666666666667,No Limit Hold'em
4111,2/28/2023 11:00:00 am,Horseshoe Las Vegas,89109,NLH,75,50,25,0.6666666666666666,No Limit Hold'em
4112,2/28/2023 11:00:00 am,MGM Grand,89109,NLH,100,75,25,0.75,No Limit Hold'em
4113,2/28/2023 11:05:00 am,The Orleans Casino,89103,NLH,100,76,24,0.76,Super Stack No-Limit Hold'em
4114,2/28/2023 12:00:00 pm,Wynn Casino,89109,NLH,200,165,35,0.825,No Limit Hold'em
4115,2/28/2023 1:00:00 pm,Aria Casino,89158,NLH,160,125,35,0.78125,No Limit Hold'em
4116,2/28/2023 2:00:00 pm,Horseshoe Las Vegas,89109,NLH,75,50,25,0.6666666666666666,No Limit Hold'em
4117,2/28/2023 2:00:00 pm,Caesars Palace,89109,NLH,150,115,35,0.7666666666666667,No Limit Hold'em
4118,2/28/2023 2:00:00 pm,MGM Grand,89109,NLH,100,75,25,0.75,No Limit Hold'em Turbo
4119,2/28/2023 2:05:00 pm,South Point Casino,89183,FLO8,60,43,17,0.7166666666666667,Omaha 8/B
4120,2/28/2023 5:00:00 pm,Horseshoe Las Vegas,89109,NLH,75,50,25,0.6666666666666666,No Limit Hold'em
4121,2/28/2023 5:00:00 pm,Bellagio Casino,89109,NLH,160,125,35,0.78125,No Limit Hold'em
4122,2/28/2023 6:00:00 pm,Caesars Palace,89109,NLH,100,75,25,0.75,No Limit Hold'em
4123,2/28/2023 6:05:00 pm,South Point Casino,89183,NLH,60,43,17,0.7166666666666667,No Limit Hold'em
4124,2/28/2023 7:00:00 pm,MGM Grand,89109,NLH,100,75,25,0.75,No Limit Hold'em
4125,2/28/2023 7:05:00 pm,The Orleans Casino,89103,NLH,100,76,24,0.76,Super Stack No-Limit Hold'em
4126,2/28/2023 8:00:00 pm,Horseshoe Las Vegas,89109,NLH,75,50,25,0.6666666666666666,No Limit Hold'em
4127,2/28/2023 9:00:00 pm,Caesars Palace,89109,NLH,150,115,35,0.7666666666666667,No Limit Hold'em
4128,2/28/2023 10:05:00 pm,South Point Casino,89183,NLH,60,47,13,0.7833333333333333,No Limit Hold'em Turbo
4129,2/28/2023 11:00:00 pm,Horseshoe Las Vegas,89109,NLH,75,50,25,0.6666666666666666,No Limit Hold'em
4130,2/28/2023 11:59:00 pm,MGM Grand,89109,NLH,100,75,25,0.75,Midnight Maddness Hyper Turbo
4131,3/01/2023 12:00:00 am,Caesars Palace,89109,NLH,100,75,25,0.75,No Limit Hold'em
4132,3/01/2023 9:00:00 am,Horseshoe Las Vegas,89109,NLH,75,50,25,0.6666666666666666,No Limit Hold'em
4133,3/01/2023 10:00:00 am,Caesars Palace,89109,NLH,100,75,25,0.75,No Limit Hold'em
4134,3/01/2023 10:05:00 am,South Point Casino,89183,NLH,60,43,17,0.7166666666666667,No Limit Hold'em
4135,3/01/2023 11:00:00 am,Horseshoe Las Vegas,89109,NLH,75,50,25,0.6666666666666666,No Limit Hold'em
4136,3/01/2023 11:00:00 am,MGM Grand,89109,NLH,100,75,25,0.75,No Limit Hold'em
4137,3/01/2023 11:05:00 am,The Orleans Casino,89103,NLH,100,76,24,0.76,Super Stack No-Limit Hold'em
4138,3/01/2023 12:00:00 pm,Wynn Casino,89109,NLH,200,165,35,0.825,No Limit Hold'em
4139,3/01/2023 1:00:00 pm,Aria Casino,89158,NLH,160,125,35,0.78125,No Limit Hold'em
4140,3/01/2023 2:00:00 pm,Horseshoe Las Vegas,89109,NLH,75,50,25,0.6666666666666666,No Limit Hold'em
4141,3/01/2023 2:00:00 pm,Caesars Palace,89109,NLH,150,115,35,0.7666666666666667,No Limit Hold'em
4142,3/01/2023 2:00:00 pm,MGM Grand,89109,NLH,100,75,25,0.75,No Limit Hold'em Turbo
4143,3/01/2023 2:05:00 pm,South Point Casino,89183,NLH,60,43,17,0.7166666666666667,No Limit Hold'em Turbo
4144,3/01/2023 4:05:00 pm,The Orleans Casino,89103,O8/S8,150,118,32,0.7866666666666666,Omaha 8/B / Stud 8
4145,3/01/2023 5:00:00 pm,Horseshoe Las Vegas,89109,NLH,75,50,25,0.6666666666666666,No Limit Hold'em
4146,3/01/2023 5:00:00 pm,Bellagio Casino,89109,NLH,160,125,35,0.78125,No Limit Hold'em
4147,3/01/2023 6:00:00 pm,Caesars Palace,89109,NLH,100,75,25,0.75,No Limit Hold'em
4148,3/01/2023 6:05:00 pm,South Point Casino,89183,NLH,150,118,32,0.7866666666666666,No Limit Hold'em Deep Stack
4149,3/01/2023 7:00:00 pm,MGM Grand,89109,NLH,100,75,25,0.75,No Limit Hold'em
4150,3/01/2023 7:05:00 pm,The Orleans Casino,89103,NLH,125,100,25,0.8,No Limit Hold'em Survivor
4151,3/01/2023 8:00:00 pm,Horseshoe Las Vegas,89109,NLH,75,50,25,0.6666666666666666,No Limit Hold'em
4152,3/01/2023 9:00:00 pm,Caesars Palace,89109,NLH,150,115,35,0.7666666666666667,No Limit Hold'em
4153,3/01/2023 10:05:00 pm,South Point Casino,89183,NLH,60,47,13,0.7833333333333333,No Limit Hold'em Turbo
4154,3/01/2023 11:00:00 pm,Horseshoe Las Vegas,89109,NLH,75,50,25,0.6666666666666666,No Limit Hold'em
4155,3/01/2023 11:59:00 pm,MGM Grand,89109,NLH,100,75,25,0.75,Midnight Maddness Hyper Turbo
4156,3/02/2023 12:00:00 am,Caesars Palace,89109,NLH,100,75,25,0.75,No Limit Hold'em
4157,3/02/2023 9:00:00 am,Horseshoe Las Vegas,89109,NLH,75,50,25,0.6666666666666666,No Limit Hold'em
4158,3/02/2023 10:00:00 am,Caesars Palace,89109,NLH,100,75,25,0.75,No Limit Hold'em
4159,3/02/2023 10:05:00 am,South Point Casino,89183,NLH,60,43,17,0.7166666666666667,No Limit Hold'em
4160,3/02/2023 11:00:00 am,Horseshoe Las Vegas,89109,NLH,75,50,25,0.6666666666666666,No Limit Hold'em
4161,3/02/2023 11:00:00 am,MGM Grand,89109,NLH,100,75,25,0.75,No Limit Hold'em
4162,3/02/2023 11:05:00 am,The Orleans Casino,89103,NLH,100,76,24,0.76,Super Stack No-Limit Hold'em
4163,3/02/2023 12:00:00 pm,Wynn Casino,89109,NLH,200,165,35,0.825,No Limit Hold'em
4164,3/02/2023 1:00:00 pm,Aria Casino,89158,NLH,160,125,35,0.78125,No Limit Hold'em
4165,3/02/2023 2:00:00 pm,Horseshoe Las Vegas,89109,NLH,75,50,25,0.6666666666666666,No Limit Hold'em
4166,3/02/2023 2:00:00 pm,Caesars Palace,89109,NLH,150,115,35,0.7666666666666667,No Limit Hold'em
4167,3/02/2023 2:00:00 pm,MGM Grand,89109,NLH,100,75,25,0.75,No Limit Hold'em Turbo
4168,3/02/2023 2:00:00 pm,South Point Casino,89183,O8/S8,150,118,32,0.7866666666666666,Omaha 8 / Stud 8
4169,3/02/2023 5:00:00 pm,Horseshoe Las Vegas,89109,NLH,75,50,25,0.6666666666666666,No Limit Hold'em
4170,3/02/2023 5:00:00 pm,Bellagio Casino,89109,NLH,160,125,35,0.78125,No Limit Hold'em
4171,3/02/2023 6:00:00 pm,Caesars Palace,89109,NLH,100,75,25,0.75,No Limit Hold'em
4172,3/02/2023 6:05:00 pm,South Point Casino,89183,NLH,60,43,17,0.7166666666666667,No Limit Hold'em
4173,3/02/2023 7:00:00 pm,MGM Grand,89109,NLH,100,75,25,0.75,No Limit Hold'em
4174,3/02/2023 7:05:00 pm,The Orleans Casino,89103,NLH,100,76,24,0.76,Super Stack No-Limit Hold'em
4175,3/02/2023 8:00:00 pm,Mandalay Bay,89119,NLH,60,40,20,0.6666666666666666,No Limit Hold'em
4176,3/02/2023 8:00:00 pm,Horseshoe Las Vegas,89109,NLH,75,50,25,0.6666666666666666,No Limit Hold'em
4177,3/02/2023 9:00:00 pm,Caesars Palace,89109,NLH,150,115,35,0.7666666666666667,No Limit Hold'em
4178,3/02/2023 10:05:00 pm,South Point Casino,89183,NLH,60,47,13,0.7833333333333333,No Limit Hold'em Turbo
4179,3/02/2023 11:00:00 pm,Horseshoe Las Vegas,89109,NLH,75,50,25,0.6666666666666666,No Limit Hold'em
4180,3/02/2023 11:59:00 pm,MGM Grand,89109,NLH,100,75,25,0.75,Midnight Maddness Hyper Turbo
4181,3/03/2023 12:00:00 am,Caesars Palace,89109,NLH,100,75,25,0.75,No Limit Hold'em
4182,3/03/2023 9:00:00 am,Horseshoe Las Vegas,89109,NLH,75,50,25,0.6666666666666666,No Limit Hold'em
4183,3/03/2023 10:00:00 am,Caesars Palace,89109,NLH,100,75,25,0.75,No Limit Hold'em
4184,3/03/2023 10:05:00 am,South Point Casino,89183,NLH,60,43,17,0.7166666666666667,No Limit Hold'em
4185,3/03/2023 11:00:00 am,Horseshoe Las Vegas,89109,NLH,75,50,25,0.6666666666666666,No Limit Hold'em
4186,3/03/2023 11:00:00 am,MGM Grand,89109,NLH,100,75,25,0.75,No Limit Hold'em
4187,3/03/2023 11:00:00 am,Wynn Casino,89109,NLH,230,190,40,0.8260869565217391,No Limit Hold'em
4188,3/03/2023 11:05:00 am,The Orleans Casino,89103,NLH,100,76,24,0.76,Super Stack No-Limit Hold'em
4189,3/03/2023 1:00:00 pm,Aria Casino,89158,NLH,240,195,45,0.8125,No Limit Hold'em
4190,3/03/2023 2:00:00 pm,Horseshoe Las Vegas,89109,NLH,75,50,25,0.6666666666666666,No Limit Hold'em
4191,3/03/2023 2:00:00 pm,Caesars Palace,89109,NLH,150,115,35,0.7666666666666667,No Limit Hold'em
4192,3/03/2023 2:00:00 pm,MGM Grand,89109,NLH,100,75,25,0.75,No Limit Hold'em Turbo
4193,3/03/2023 2:05:00 pm,South Point Casino,89183,NLH,60,43,17,0.7166666666666667,No Limit Hold'em Turbo
4194,3/03/2023 5:00:00 pm,Horseshoe Las Vegas,89109,NLH,75,50,25,0.6666666666666666,No Limit Hold'em
4195,3/03/2023 6:00:00 pm,Caesars Palace,89109,NLH,100,75,25,0.75,No Limit Hold'em
4196,3/03/2023 6:00:00 pm,South Point Casino,89183,NLH,150,118,32,0.7866666666666666,No Limit Hold'em Double Green Chip Bounty
4197,3/03/2023 6:30:00 pm,Poker Palace Casino,89030,NLH,20,10,10,0.5,No Limit Hold'em
4198,1/15/2023 11:00:00 am,Atlantis Casino,89502,NLH,20,15,5,0.75,No Limit Hold'em
4199,1/15/2023 12:00:00 pm,Carson Valley Inn,89423,NLH,30,25,5,0.8333333333333334,No Limit Hold'em
4200,1/15/2023 12:00:00 pm,Peppermill Casino,89502,NLH,135,100,35,0.7407407407407407,No Limit Hold'em
4201,1/15/2023 12:00:00 pm,Grand Sierra Resort Casino,89595,NLH,50,50,0% of total prize pool is set aside for poker staff,1.0,No Limit Hold'em
4202,1/15/2023 6:30:00 pm,Grand Sierra Resort Casino,89595,NLH,50,50,0% of total prize pool is set aside for poker staff,1.0,No Limit Hold'em
4203,1/16/2023 11:00:00 am,Atlantis Casino,89502,NLH,20,15,5,0.75,No Limit Hold'em
4204,1/16/2023 12:00:00 pm,Peppermill Casino,89502,NLH,135,100,35,0.7407407407407407,No Limit Hold'em
4205,1/16/2023 6:30:00 pm,Grand Sierra Resort Casino,89595,NLH,50,50,0% of total prize pool is set aside for poker staff,1.0,No Limit Hold'em
4206,1/17/2023 11:00:00 am,Atlantis Casino,89502,NLH,20,15,5,0.75,No Limit Hold'em
4207,1/17/2023 12:00:00 pm,Carson Valley Inn,89423,NLH,30,25,5,0.8333333333333334,No Limit Hold'em
4208,1/17/2023 12:00:00 pm,Peppermill Casino,89502,NLH,135,100,35,0.7407407407407407,No Limit Hold'em
4209,1/17/2023 6:00:00 pm,Carson Valley Inn,89423,NLH,30,25,5,0.8333333333333334,No Limit Hold'em
4210,1/17/2023 6:30:00 pm,Grand Sierra Resort Casino,89595,NLH,50,50,0% of total prize pool is set aside for poker staff,1.0,No Limit Hold'em
4211,1/18/2023 11:00:00 am,Atlantis Casino,89502,NLH,20,15,5,0.75,No Limit Hold'em
4212,1/18/2023 12:00:00 pm,Peppermill Casino,89502,NLH,135,100,35,0.7407407407407407,No Limit Hold'em
4213,1/18/2023 6:00:00 pm,Peppermill Casino,89502,NLH,240,200,40,0.8333333333333334,No Limit Hold'em Black Chip Bounty
4214,1/18/2023 6:30:00 pm,Grand Sierra Resort Casino,89595,NLH,50,50,0% of total prize pool is set aside for poker staff,1.0,No Limit Hold'em
4215,1/19/2023 11:00:00 am,Atlantis Casino,89502,NLH,20,15,5,0.75,No Limit Hold'em
4216,1/19/2023 12:00:00 pm,Carson Valley Inn,89423,NLH,30,25,5,0.8333333333333334,No Limit Hold'em
4217,1/19/2023 12:00:00 pm,Peppermill Casino,89502,NLH,135,100,35,0.7407407407407407,No Limit Hold'em
4218,1/19/2023 6:00:00 pm,Carson Valley Inn,89423,NLH,30,25,5,0.8333333333333334,No Limit Hold'em
4219,1/19/2023 6:30:00 pm,Grand Sierra Resort Casino,89595,NLH,50,50,0% of total prize pool is set aside for poker staff,1.0,No Limit Hold'em
4220,1/20/2023 11:00:00 am,Atlantis Casino,89502,NLH,20,15,5,0.75,No Limit Hold'em
4221,1/20/2023 12:00:00 pm,Peppermill Casino,89502,NLH,135,100,35,0.7407407407407407,No Limit Hold'em
4222,1/20/2023 6:30:00 pm,Grand Sierra Resort Casino,89595,NLH,100,100,0% of total prize pool is set aside for poker staff,1.0,No Limit Hold'em
4223,1/21/2023 12:00:00 pm,Peppermill Casino,89502,NLH,245,200,45,0.8163265306122449,No Limit Hold'em
4224,1/21/2023 12:00:00 pm,Grand Sierra Resort Casino,89595,NLH,50,50,0% of total prize pool is set aside for poker staff,1.0,No Limit Hold'em
4225,1/21/2023 6:30:00 pm,Grand Sierra Resort Casino,89595,NLH,100,100,0% of total prize pool is set aside for poker staff,1.0,No Limit Hold'em
4226,1/22/2023 11:00:00 am,Atlantis Casino,89502,NLH,20,15,5,0.75,No Limit Hold'em
4227,1/22/2023 12:00:00 pm,Carson Valley Inn,89423,NLH,30,25,5,0.8333333333333334,No Limit Hold'em
4228,1/22/2023 12:00:00 pm,Peppermill Casino,89502,NLH,135,100,35,0.7407407407407407,No Limit Hold'em
4229,1/22/2023 12:00:00 pm,Grand Sierra Resort Casino,89595,NLH,50,50,0% of total prize pool is set aside for poker staff,1.0,No Limit Hold'em
4230,1/22/2023 6:30:00 pm,Grand Sierra Resort Casino,89595,NLH,50,50,0% of total prize pool is set aside for poker staff,1.0,No Limit Hold'em
4231,1/23/2023 11:00:00 am,Atlantis Casino,89502,NLH,20,15,5,0.75,No Limit Hold'em
4232,1/23/2023 12:00:00 pm,Peppermill Casino,89502,NLH,135,100,35,0.7407407407407407,No Limit Hold'em
4233,1/23/2023 6:30:00 pm,Grand Sierra Resort Casino,89595,NLH,50,50,0% of total prize pool is set aside for poker staff,1.0,No Limit Hold'em
4234,1/24/2023 11:00:00 am,Atlantis Casino,89502,NLH,20,15,5,0.75,No Limit Hold'em
4235,1/24/2023 12:00:00 pm,Carson Valley Inn,89423,NLH,30,25,5,0.8333333333333334,No Limit Hold'em
4236,1/24/2023 12:00:00 pm,Peppermill Casino,89502,NLH,135,100,35,0.7407407407407407,No Limit Hold'em
4237,1/24/2023 6:00:00 pm,Carson Valley Inn,89423,NLH,30,25,5,0.8333333333333334,No Limit Hold'em
4238,1/24/2023 6:30:00 pm,Grand Sierra Resort Casino,89595,NLH,50,50,0% of total prize pool is set aside for poker staff,1.0,No Limit Hold'em
4239,1/25/2023 11:00:00 am,Atlantis Casino,89502,NLH,20,15,5,0.75,No Limit Hold'em
4240,1/25/2023 12:00:00 pm,Peppermill Casino,89502,NLH,135,100,35,0.7407407407407407,No Limit Hold'em
4241,1/25/2023 6:00:00 pm,Peppermill Casino,89502,NLH,240,200,40,0.8333333333333334,No Limit Hold'em Black Chip Bounty
4242,1/25/2023 6:30:00 pm,Grand Sierra Resort Casino,89595,NLH,50,50,0% of total prize pool is set aside for poker staff,1.0,No Limit Hold'em
4243,1/26/2023 11:00:00 am,Atlantis Casino,89502,NLH,20,15,5,0.75,No Limit Hold'em
4244,1/26/2023 12:00:00 pm,Carson Valley Inn,89423,NLH,30,25,5,0.8333333333333334,No Limit Hold'em
4245,1/26/2023 12:00:00 pm,Peppermill Casino,89502,NLH,135,100,35,0.7407407407407407,No Limit Hold'em
4246,1/26/2023 6:00:00 pm,Carson Valley Inn,89423,NLH,30,25,5,0.8333333333333334,No Limit Hold'em
4247,1/26/2023 6:30:00 pm,Grand Sierra Resort Casino,89595,NLH,50,50,0% of total prize pool is set aside for poker staff,1.0,No Limit Hold'em
4248,1/27/2023 11:00:00 am,Atlantis Casino,89502,NLH,20,15,5,0.75,No Limit Hold'em
4249,1/27/2023 12:00:00 pm,Peppermill Casino,89502,NLH,135,100,35,0.7407407407407407,No Limit Hold'em
4250,1/27/2023 6:30:00 pm,Grand Sierra Resort Casino,89595,NLH,100,100,0% of total prize pool is set aside for poker staff,1.0,No Limit Hold'em
4251,1/28/2023 11:00:00 am,Atlantis Casino,89502,NLH,20,15,5,0.75,No Limit Hold'em
4252,1/28/2023 12:00:00 pm,Peppermill Casino,89502,NLH,245,200,45,0.8163265306122449,No Limit Hold'em
4253,1/28/2023 12:00:00 pm,Grand Sierra Resort Casino,89595,NLH,50,50,0% of total prize pool is set aside for poker staff,1.0,No Limit Hold'em
4254,1/28/2023 6:30:00 pm,Grand Sierra Resort Casino,89595,NLH,100,100,0% of total prize pool is set aside for poker staff,1.0,No Limit Hold'em
4255,1/29/2023 11:00:00 am,Atlantis Casino,89502,NLH,20,15,5,0.75,No Limit Hold'em
4256,1/29/2023 12:00:00 pm,Carson Valley Inn,89423,NLH,30,25,5,0.8333333333333334,No Limit Hold'em
4257,1/29/2023 12:00:00 pm,Peppermill Casino,89502,NLH,135,100,35,0.7407407407407407,No Limit Hold'em
4258,1/29/2023 12:00:00 pm,Grand Sierra Resort Casino,89595,NLH,50,50,0% of total prize pool is set aside for poker staff,1.0,No Limit Hold'em
4259,1/29/2023 6:30:00 pm,Grand Sierra Resort Casino,89595,NLH,50,50,0% of total prize pool is set aside for poker staff,1.0,No Limit Hold'em
4260,1/30/2023 11:00:00 am,Atlantis Casino,89502,NLH,20,15,5,0.75,No Limit Hold'em
4261,1/30/2023 12:00:00 pm,Peppermill Casino,89502,NLH,135,100,35,0.7407407407407407,No Limit Hold'em
4262,1/30/2023 6:30:00 pm,Grand Sierra Resort Casino,89595,NLH,50,50,0% of total prize pool is set aside for poker staff,1.0,No Limit Hold'em
4263,1/31/2023 11:00:00 am,Atlantis Casino,89502,NLH,20,15,5,0.75,No Limit Hold'em
4264,1/31/2023 12:00:00 pm,Carson Valley Inn,89423,NLH,30,25,5,0.8333333333333334,No Limit Hold'em
4265,1/31/2023 12:00:00 pm,Peppermill Casino,89502,NLH,135,100,35,0.7407407407407407,No Limit Hold'em
4266,1/31/2023 6:00:00 pm,Carson Valley Inn,89423,NLH,30,25,5,0.8333333333333334,No Limit Hold'em
4267,1/31/2023 6:30:00 pm,Grand Sierra Resort Casino,89595,NLH,50,50,0% of total prize pool is set aside for poker staff,1.0,No Limit Hold'em
4268,2/01/2023 11:00:00 am,Atlantis Casino,89502,NLH,20,15,5,0.75,No Limit Hold'em
4269,2/01/2023 12:00:00 pm,Peppermill Casino,89502,NLH,135,100,35,0.7407407407407407,No Limit Hold'em
4270,2/01/2023 6:00:00 pm,Peppermill Casino,89502,NLH,240,200,40,0.8333333333333334,No Limit Hold'em Black Chip Bounty
4271,2/01/2023 6:30:00 pm,Grand Sierra Resort Casino,89595,NLH,50,50,0% of total prize pool is set aside for poker staff,1.0,No Limit Hold'em
4272,2/02/2023 11:00:00 am,Atlantis Casino,89502,NLH,20,15,5,0.75,No Limit Hold'em
4273,2/02/2023 12:00:00 pm,Carson Valley Inn,89423,NLH,30,25,5,0.8333333333333334,No Limit Hold'em
4274,2/02/2023 12:00:00 pm,Peppermill Casino,89502,NLH,135,100,35,0.7407407407407407,No Limit Hold'em
4275,2/02/2023 6:00:00 pm,Carson Valley Inn,89423,NLH,30,25,5,0.8333333333333334,No Limit Hold'em
4276,2/02/2023 6:30:00 pm,Grand Sierra Resort Casino,89595,NLH,50,50,0% of total prize pool is set aside for poker staff,1.0,No Limit Hold'em
4277,2/03/2023 11:00:00 am,Atlantis Casino,89502,NLH,20,15,5,0.75,No Limit Hold'em
4278,2/03/2023 12:00:00 pm,Peppermill Casino,89502,NLH,135,100,35,0.7407407407407407,No Limit Hold'em
4279,2/03/2023 6:30:00 pm,Grand Sierra Resort Casino,89595,NLH,100,100,0% of total prize pool is set aside for poker staff,1.0,No Limit Hold'em
4280,2/04/2023 11:00:00 am,Atlantis Casino,89502,NLH,20,15,5,0.75,No Limit Hold'em
4281,2/04/2023 12:00:00 pm,Peppermill Casino,89502,NLH,245,200,45,0.8163265306122449,No Limit Hold'em
4282,2/04/2023 12:00:00 pm,Grand Sierra Resort Casino,89595,NLH,50,50,0% of total prize pool is set aside for poker staff,1.0,No Limit Hold'em
4283,2/04/2023 6:30:00 pm,Grand Sierra Resort Casino,89595,NLH,100,100,0% of total prize pool is set aside for poker staff,1.0,No Limit Hold'em
4284,2/05/2023 11:00:00 am,Atlantis Casino,89502,NLH,20,15,5,0.75,No Limit Hold'em
4285,2/05/2023 12:00:00 pm,Carson Valley Inn,89423,NLH,30,25,5,0.8333333333333334,No Limit Hold'em
4286,2/05/2023 12:00:00 pm,Peppermill Casino,89502,NLH,135,100,35,0.7407407407407407,No Limit Hold'em
4287,2/05/2023 12:00:00 pm,Grand Sierra Resort Casino,89595,NLH,50,50,0% of total prize pool is set aside for poker staff,1.0,No Limit Hold'em
4288,2/05/2023 6:30:00 pm,Grand Sierra Resort Casino,89595,NLH,50,50,0% of total prize pool is set aside for poker staff,1.0,No Limit Hold'em
4289,2/06/2023 11:00:00 am,Atlantis Casino,89502,NLH,20,15,5,0.75,No Limit Hold'em
4290,2/06/2023 12:00:00 pm,Peppermill Casino,89502,NLH,135,100,35,0.7407407407407407,No Limit Hold'em
4291,2/06/2023 6:30:00 pm,Grand Sierra Resort Casino,89595,NLH,50,50,0% of total prize pool is set aside for poker staff,1.0,No Limit Hold'em
4292,2/07/2023 11:00:00 am,Atlantis Casino,89502,NLH,20,15,5,0.75,No Limit Hold'em
4293,2/07/2023 12:00:00 pm,Carson Valley Inn,89423,NLH,30,25,5,0.8333333333333334,No Limit Hold'em
4294,2/07/2023 12:00:00 pm,Peppermill Casino,89502,NLH,135,100,35,0.7407407407407407,No Limit Hold'em
4295,2/07/2023 6:00:00 pm,Carson Valley Inn,89423,NLH,30,25,5,0.8333333333333334,No Limit Hold'em
4296,2/07/2023 6:30:00 pm,Grand Sierra Resort Casino,89595,NLH,50,50,0% of total prize pool is set aside for poker staff,1.0,No Limit Hold'em
4297,2/08/2023 11:00:00 am,Atlantis Casino,89502,NLH,20,15,5,0.75,No Limit Hold'em
4298,2/08/2023 12:00:00 pm,Peppermill Casino,89502,NLH,135,100,35,0.7407407407407407,No Limit Hold'em
4299,2/08/2023 6:00:00 pm,Peppermill Casino,89502,NLH,240,200,40,0.8333333333333334,No Limit Hold'em Black Chip Bounty
4300,2/08/2023 6:30:00 pm,Grand Sierra Resort Casino,89595,NLH,50,50,0% of total prize pool is set aside for poker staff,1.0,No Limit Hold'em
4301,2/09/2023 11:00:00 am,Atlantis Casino,89502,NLH,20,15,5,0.75,No Limit Hold'em
4302,2/09/2023 12:00:00 pm,Carson Valley Inn,89423,NLH,30,25,5,0.8333333333333334,No Limit Hold'em
4303,2/09/2023 12:00:00 pm,Peppermill Casino,89502,NLH,135,100,35,0.7407407407407407,No Limit Hold'em
4304,2/09/2023 6:00:00 pm,Carson Valley Inn,89423,NLH,30,25,5,0.8333333333333334,No Limit Hold'em
4305,2/09/2023 6:30:00 pm,Grand Sierra Resort Casino,89595,NLH,50,50,0% of total prize pool is set aside for poker staff,1.0,No Limit Hold'em
4306,2/10/2023 11:00:00 am,Atlantis Casino,89502,NLH,20,15,5,0.75,No Limit Hold'em
4307,2/10/2023 12:00:00 pm,Peppermill Casino,89502,NLH,135,100,35,0.7407407407407407,No Limit Hold'em
4308,2/10/2023 6:30:00 pm,Grand Sierra Resort Casino,89595,NLH,100,100,0% of total prize pool is set aside for poker staff,1.0,No Limit Hold'em
4309,2/11/2023 11:00:00 am,Atlantis Casino,89502,NLH,20,15,5,0.75,No Limit Hold'em
4310,2/11/2023 12:00:00 pm,Peppermill Casino,89502,NLH,245,200,45,0.8163265306122449,No Limit Hold'em
4311,2/11/2023 12:00:00 pm,Grand Sierra Resort Casino,89595,NLH,50,50,0% of total prize pool is set aside for poker staff,1.0,No Limit Hold'em
4312,2/11/2023 6:30:00 pm,Grand Sierra Resort Casino,89595,NLH,100,100,0% of total prize pool is set aside for poker staff,1.0,No Limit Hold'em
4313,2/12/2023 11:00:00 am,Grand Sierra Resort Casino,89595,NLH,145,110,35,0.7586206896551724,Second Sunday of the Month Tournament
4314,2/12/2023 11:00:00 am,Atlantis Casino,89502,NLH,20,15,5,0.75,No Limit Hold'em
4315,2/12/2023 12:00:00 pm,Carson Valley Inn,89423,NLH,30,25,5,0.8333333333333334,No Limit Hold'em
4316,2/12/2023 12:00:00 pm,Peppermill Casino,89502,NLH,135,100,35,0.7407407407407407,No Limit Hold'em
4317,2/12/2023 6:30:00 pm,Grand Sierra Resort Casino,89595,NLH,50,50,0% of total prize pool is set aside for poker staff,1.0,No Limit Hold'em
4318,2/13/2023 11:00:00 am,Atlantis Casino,89502,NLH,20,15,5,0.75,No Limit Hold'em
4319,2/13/2023 12:00:00 pm,Peppermill Casino,89502,NLH,135,100,35,0.7407407407407407,No Limit Hold'em
4320,2/13/2023 6:30:00 pm,Grand Sierra Resort Casino,89595,NLH,50,50,0% of total prize pool is set aside for poker staff,1.0,No Limit Hold'em
4321,2/14/2023 11:00:00 am,Atlantis Casino,89502,NLH,20,15,5,0.75,No Limit Hold'em
4322,2/14/2023 12:00:00 pm,Carson Valley Inn,89423,NLH,30,25,5,0.8333333333333334,No Limit Hold'em
4323,2/14/2023 12:00:00 pm,Peppermill Casino,89502,NLH,135,100,35,0.7407407407407407,No Limit Hold'em
4324,2/14/2023 6:00:00 pm,Carson Valley Inn,89423,NLH,30,25,5,0.8333333333333334,No Limit Hold'em
4325,2/14/2023 6:30:00 pm,Grand Sierra Resort Casino,89595,NLH,50,50,0% of total prize pool is set aside for poker staff,1.0,No Limit Hold'em
4326,2/15/2023 11:00:00 am,Atlantis Casino,89502,NLH,20,15,5,0.75,No Limit Hold'em
4327,2/15/2023 12:00:00 pm,Peppermill Casino,89502,NLH,135,100,35,0.7407407407407407,No Limit Hold'em
4328,2/15/2023 6:00:00 pm,Peppermill Casino,89502,NLH,240,200,40,0.8333333333333334,No Limit Hold'em Black Chip Bounty
4329,2/15/2023 6:30:00 pm,Grand Sierra Resort Casino,89595,NLH,50,50,0% of total prize pool is set aside for poker staff,1.0,No Limit Hold'em
4330,2/16/2023 11:00:00 am,Atlantis Casino,89502,NLH,20,15,5,0.75,No Limit Hold'em
4331,2/16/2023 12:00:00 pm,Carson Valley Inn,89423,NLH,30,25,5,0.8333333333333334,No Limit Hold'em
4332,2/16/2023 12:00:00 pm,Peppermill Casino,89502,NLH,135,100,35,0.7407407407407407,No Limit Hold'em
4333,2/16/2023 6:00:00 pm,Carson Valley Inn,89423,NLH,30,25,5,0.8333333333333334,No Limit Hold'em
4334,2/16/2023 6:30:00 pm,Grand Sierra Resort Casino,89595,NLH,50,50,0% of total prize pool is set aside for poker staff,1.0,No Limit Hold'em
4335,2/17/2023 11:00:00 am,Atlantis Casino,89502,NLH,20,15,5,0.75,No Limit Hold'em
4336,2/17/2023 12:00:00 pm,Peppermill Casino,89502,NLH,135,100,35,0.7407407407407407,No Limit Hold'em
4337,2/17/2023 6:30:00 pm,Grand Sierra Resort Casino,89595,NLH,100,100,0% of total prize pool is set aside for poker staff,1.0,No Limit Hold'em
4338,2/18/2023 11:00:00 am,Atlantis Casino,89502,NLH,20,15,5,0.75,No Limit Hold'em
4339,2/18/2023 12:00:00 pm,Peppermill Casino,89502,NLH,245,200,45,0.8163265306122449,No Limit Hold'em
4340,2/18/2023 12:00:00 pm,Grand Sierra Resort Casino,89595,NLH,50,50,0% of total prize pool is set aside for poker staff,1.0,No Limit Hold'em
4341,2/18/2023 6:30:00 pm,Grand Sierra Resort Casino,89595,NLH,100,100,0% of total prize pool is set aside for poker staff,1.0,No Limit Hold'em
4342,2/19/2023 11:00:00 am,Atlantis Casino,89502,NLH,20,15,5,0.75,No Limit Hold'em
4343,2/19/2023 12:00:00 pm,Carson Valley Inn,89423,NLH,30,25,5,0.8333333333333334,No Limit Hold'em
4344,2/19/2023 12:00:00 pm,Peppermill Casino,89502,NLH,135,100,35,0.7407407407407407,No Limit Hold'em
4345,2/19/2023 12:00:00 pm,Grand Sierra Resort Casino,89595,NLH,50,50,0% of total prize pool is set aside for poker staff,1.0,No Limit Hold'em
4346,2/19/2023 6:30:00 pm,Grand Sierra Resort Casino,89595,NLH,50,50,0% of total prize pool is set aside for poker staff,1.0,No Limit Hold'em
4347,2/20/2023 11:00:00 am,Atlantis Casino,89502,NLH,20,15,5,0.75,No Limit Hold'em
4348,2/20/2023 12:00:00 pm,Peppermill Casino,89502,NLH,135,100,35,0.7407407407407407,No Limit Hold'em
4349,2/20/2023 6:30:00 pm,Grand Sierra Resort Casino,89595,NLH,50,50,0% of total prize pool is set aside for poker staff,1.0,No Limit Hold'em
4350,2/21/2023 11:00:00 am,Atlantis Casino,89502,NLH,20,15,5,0.75,No Limit Hold'em
4351,2/21/2023 12:00:00 pm,Carson Valley Inn,89423,NLH,30,25,5,0.8333333333333334,No Limit Hold'em
4352,2/21/2023 12:00:00 pm,Peppermill Casino,89502,NLH,135,100,35,0.7407407407407407,No Limit Hold'em
4353,2/21/2023 6:00:00 pm,Carson Valley Inn,89423,NLH,30,25,5,0.8333333333333334,No Limit Hold'em
4354,2/21/2023 6:30:00 pm,Grand Sierra Resort Casino,89595,NLH,50,50,0% of total prize pool is set aside for poker staff,1.0,No Limit Hold'em
4355,2/22/2023 11:00:00 am,Atlantis Casino,89502,NLH,20,15,5,0.75,No Limit Hold'em
4356,2/22/2023 12:00:00 pm,Peppermill Casino,89502,NLH,135,100,35,0.7407407407407407,No Limit Hold'em
4357,2/22/2023 6:00:00 pm,Peppermill Casino,89502,NLH,240,200,40,0.8333333333333334,No Limit Hold'em Black Chip Bounty
4358,2/22/2023 6:30:00 pm,Grand Sierra Resort Casino,89595,NLH,50,50,0% of total prize pool is set aside for poker staff,1.0,No Limit Hold'em
4359,2/23/2023 11:00:00 am,Atlantis Casino,89502,NLH,20,15,5,0.75,No Limit Hold'em
4360,2/23/2023 12:00:00 pm,Carson Valley Inn,89423,NLH,30,25,5,0.8333333333333334,No Limit Hold'em
4361,2/23/2023 12:00:00 pm,Peppermill Casino,89502,NLH,135,100,35,0.7407407407407407,No Limit Hold'em
4362,2/23/2023 6:00:00 pm,Carson Valley Inn,89423,NLH,30,25,5,0.8333333333333334,No Limit Hold'em
4363,2/23/2023 6:30:00 pm,Grand Sierra Resort Casino,89595,NLH,50,50,0% of total prize pool is set aside for poker staff,1.0,No Limit Hold'em
4364,2/24/2023 11:00:00 am,Atlantis Casino,89502,NLH,20,15,5,0.75,No Limit Hold'em
4365,2/24/2023 12:00:00 pm,Peppermill Casino,89502,NLH,135,100,35,0.7407407407407407,No Limit Hold'em
4366,2/24/2023 6:30:00 pm,Grand Sierra Resort Casino,89595,NLH,100,100,0% of total prize pool is set aside for poker staff,1.0,No Limit Hold'em
4367,2/25/2023 12:00:00 pm,Peppermill Casino,89502,NLH,245,200,45,0.8163265306122449,No Limit Hold'em
4368,2/26/2023 12:00:00 pm,Carson Valley Inn,89423,NLH,30,25,5,0.8333333333333334,No Limit Hold'em
4369,2/26/2023 12:00:00 pm,Peppermill Casino,89502,NLH,135,100,35,0.7407407407407407,No Limit Hold'em
4370,2/27/2023 11:00:00 am,Atlantis Casino,89502,NLH,20,15,5,0.75,No Limit Hold'em
4371,2/27/2023 12:00:00 pm,Peppermill Casino,89502,NLH,135,100,35,0.7407407407407407,No Limit Hold'em
4372,2/27/2023 6:30:00 pm,Grand Sierra Resort Casino,89595,NLH,50,50,0% of total prize pool is set aside for poker staff,1.0,No Limit Hold'em
4373,2/28/2023 11:00:00 am,Atlantis Casino,89502,NLH,20,15,5,0.75,No Limit Hold'em
4374,2/28/2023 12:00:00 pm,Carson Valley Inn,89423,NLH,30,25,5,0.8333333333333334,No Limit Hold'em
4375,2/28/2023 12:00:00 pm,Peppermill Casino,89502,NLH,135,100,35,0.7407407407407407,No Limit Hold'em
4376,2/28/2023 6:00:00 pm,Carson Valley Inn,89423,NLH,30,25,5,0.8333333333333334,No Limit Hold'em
4377,2/28/2023 6:30:00 pm,Grand Sierra Resort Casino,89595,NLH,50,50,0% of total prize pool is set aside for poker staff,1.0,No Limit Hold'em
4378,3/01/2023 11:00:00 am,Atlantis Casino,89502,NLH,20,15,5,0.75,No Limit Hold'em
4379,3/01/2023 12:00:00 pm,Peppermill Casino,89502,NLH,135,100,35,0.7407407407407407,No Limit Hold'em
4380,3/01/2023 6:00:00 pm,Peppermill Casino,89502,NLH,240,200,40,0.8333333333333334,No Limit Hold'em Black Chip Bounty
4381,3/01/2023 6:30:00 pm,Grand Sierra Resort Casino,89595,NLH,50,50,0% of total prize pool is set aside for poker staff,1.0,No Limit Hold'em
4382,3/02/2023 11:00:00 am,Atlantis Casino,89502,NLH,20,15,5,0.75,No Limit Hold'em
4383,3/02/2023 12:00:00 pm,Carson Valley Inn,89423,NLH,30,25,5,0.8333333333333334,No Limit Hold'em
4384,3/02/2023 12:00:00 pm,Peppermill Casino,89502,NLH,135,100,35,0.7407407407407407,No Limit Hold'em
4385,3/02/2023 6:00:00 pm,Carson Valley Inn,89423,NLH,30,25,5,0.8333333333333334,No Limit Hold'em
4386,3/02/2023 6:30:00 pm,Grand Sierra Resort Casino,89595,NLH,50,50,0% of total prize pool is set aside for poker staff,1.0,No Limit Hold'em
4387,3/03/2023 11:00:00 am,Atlantis Casino,89502,NLH,20,15,5,0.75,No Limit Hold'em
4388,3/03/2023 12:00:00 pm,Peppermill Casino,89502,NLH,135,100,35,0.7407407407407407,No Limit Hold'em
4389,3/03/2023 6:30:00 pm,Grand Sierra Resort Casino,89595,NLH,100,100,0% of total prize pool is set aside for poker staff,1.0,No Limit Hold'em
4390,3/04/2023 11:00:00 am,Atlantis Casino,89502,NLH,20,15,5,0.75,No Limit Hold'em
4391,3/04/2023 12:00:00 pm,Peppermill Casino,89502,NLH,245,200,45,0.8163265306122449,No Limit Hold'em
4392,3/04/2023 12:00:00 pm,Grand Sierra Resort Casino,89595,NLH,50,50,0% of total prize pool is set aside for poker staff,1.0,No Limit Hold'em
4393,3/04/2023 6:30:00 pm,Grand Sierra Resort Casino,89595,NLH,100,100,0% of total prize pool is set aside for poker staff,1.0,No Limit Hold'em
4394,3/05/2023 11:00:00 am,Atlantis Casino,89502,NLH,20,15,5,0.75,No Limit Hold'em
4395,3/05/2023 12:00:00 pm,Carson Valley Inn,89423,NLH,30,25,5,0.8333333333333334,No Limit Hold'em
4396,3/05/2023 12:00:00 pm,Peppermill Casino,89502,NLH,135,100,35,0.7407407407407407,No Limit Hold'em
4397,3/05/2023 12:00:00 pm,Grand Sierra Resort Casino,89595,NLH,50,50,0% of total prize pool is set aside for poker staff,1.0,No Limit Hold'em
4398,3/05/2023 6:30:00 pm,Grand Sierra Resort Casino,89595,NLH,50,50,0% of total prize pool is set aside for poker staff,1.0,No Limit Hold'em
4399,3/06/2023 11:00:00 am,Atlantis Casino,89502,NLH,20,15,5,0.75,No Limit Hold'em
4400,3/06/2023 12:00:00 pm,Peppermill Casino,89502,NLH,135,100,35,0.7407407407407407,No Limit Hold'em
4401,3/06/2023 6:30:00 pm,Grand Sierra Resort Casino,89595,NLH,50,50,0% of total prize pool is set aside for poker staff,1.0,No Limit Hold'em
4402,3/07/2023 11:00:00 am,Atlantis Casino,89502,NLH,20,15,5,0.75,No Limit Hold'em
4403,3/07/2023 12:00:00 pm,Carson Valley Inn,89423,NLH,30,25,5,0.8333333333333334,No Limit Hold'em
4404,3/07/2023 12:00:00 pm,Peppermill Casino,89502,NLH,135,100,35,0.7407407407407407,No Limit Hold'em
4405,3/07/2023 6:00:00 pm,Carson Valley Inn,89423,NLH,30,25,5,0.8333333333333334,No Limit Hold'em
4406,3/07/2023 6:30:00 pm,Grand Sierra Resort Casino,89595,NLH,50,50,0% of total prize pool is set aside for poker staff,1.0,No Limit Hold'em
4407,3/08/2023 11:00:00 am,Atlantis Casino,89502,NLH,20,15,5,0.75,No Limit Hold'em
4408,3/08/2023 12:00:00 pm,Peppermill Casino,89502,NLH,135,100,35,0.7407407407407407,No Limit Hold'em
4409,3/08/2023 6:00:00 pm,Peppermill Casino,89502,NLH,240,200,40,0.8333333333333334,No Limit Hold'em Black Chip Bounty
4410,3/08/2023 6:30:00 pm,Grand Sierra Resort Casino,89595,NLH,50,50,0% of total prize pool is set aside for poker staff,1.0,No Limit Hold'em
4411,3/09/2023 11:00:00 am,Atlantis Casino,89502,NLH,20,15,5,0.75,No Limit Hold'em
4412,3/09/2023 12:00:00 pm,Carson Valley Inn,89423,NLH,30,25,5,0.8333333333333334,No Limit Hold'em
4413,3/09/2023 12:00:00 pm,Peppermill Casino,89502,NLH,135,100,35,0.7407407407407407,No Limit Hold'em
4414,3/09/2023 6:00:00 pm,Carson Valley Inn,89423,NLH,30,25,5,0.8333333333333334,No Limit Hold'em
4415,3/09/2023 6:30:00 pm,Grand Sierra Resort Casino,89595,NLH,50,50,0% of total prize pool is set aside for poker staff,1.0,No Limit Hold'em
4416,3/10/2023 11:00:00 am,Atlantis Casino,89502,NLH,20,15,5,0.75,No Limit Hold'em
4417,3/10/2023 12:00:00 pm,Peppermill Casino,89502,NLH,135,100,35,0.7407407407407407,No Limit Hold'em
4418,3/10/2023 6:30:00 pm,Grand Sierra Resort Casino,89595,NLH,100,100,0% of total prize pool is set aside for poker staff,1.0,No Limit Hold'em
4419,3/11/2023 11:00:00 am,Atlantis Casino,89502,NLH,20,15,5,0.75,No Limit Hold'em
4420,3/11/2023 12:00:00 pm,Peppermill Casino,89502,NLH,245,200,45,0.8163265306122449,No Limit Hold'em
4421,3/11/2023 12:00:00 pm,Grand Sierra Resort Casino,89595,NLH,50,50,0% of total prize pool is set aside for poker staff,1.0,No Limit Hold'em
4422,3/11/2023 6:30:00 pm,Grand Sierra Resort Casino,89595,NLH,100,100,0% of total prize pool is set aside for poker staff,1.0,No Limit Hold'em
4423,3/12/2023 11:00:00 am,Grand Sierra Resort Casino,89595,NLH,145,110,35,0.7586206896551724,Second Sunday of the Month Tournament
4424,3/12/2023 11:00:00 am,Atlantis Casino,89502,NLH,20,15,5,0.75,No Limit Hold'em
4425,3/12/2023 12:00:00 pm,Carson Valley Inn,89423,NLH,30,25,5,0.8333333333333334,No Limit Hold'em
4426,3/12/2023 12:00:00 pm,Peppermill Casino,89502,NLH,135,100,35,0.7407407407407407,No Limit Hold'em
4427,3/12/2023 6:30:00 pm,Grand Sierra Resort Casino,89595,NLH,50,50,0% of total prize pool is set aside for poker staff,1.0,No Limit Hold'em
4428,3/13/2023 11:00:00 am,Atlantis Casino,89502,NLH,20,15,5,0.75,No Limit Hold'em
4429,3/13/2023 12:00:00 pm,Peppermill Casino,89502,NLH,135,100,35,0.7407407407407407,No Limit Hold'em
4430,3/13/2023 6:30:00 pm,Grand Sierra Resort Casino,89595,NLH,50,50,0% of total prize pool is set aside for poker staff,1.0,No Limit Hold'em
4431,3/14/2023 11:00:00 am,Atlantis Casino,89502,NLH,20,15,5,0.75,No Limit Hold'em
4432,3/14/2023 12:00:00 pm,Carson Valley Inn,89423,NLH,30,25,5,0.8333333333333334,No Limit Hold'em
4433,3/14/2023 12:00:00 pm,Peppermill Casino,89502,NLH,135,100,35,0.7407407407407407,No Limit Hold'em
4434,3/14/2023 6:00:00 pm,Carson Valley Inn,89423,NLH,30,25,5,0.8333333333333334,No Limit Hold'em
4435,3/14/2023 6:30:00 pm,Grand Sierra Resort Casino,89595,NLH,50,50,0% of total prize pool is set aside for poker staff,1.0,No Limit Hold'em
4436,3/15/2023 11:00:00 am,Atlantis Casino,89502,NLH,20,15,5,0.75,No Limit Hold'em
4437,3/15/2023 12:00:00 pm,Peppermill Casino,89502,NLH,135,100,35,0.7407407407407407,No Limit Hold'em
4438,3/15/2023 6:00:00 pm,Peppermill Casino,89502,NLH,240,200,40,0.8333333333333334,No Limit Hold'em Black Chip Bounty
4439,3/15/2023 6:30:00 pm,Grand Sierra Resort Casino,89595,NLH,50,50,0% of total prize pool is set aside for poker staff,1.0,No Limit Hold'em
4440,3/16/2023 11:00:00 am,Atlantis Casino,89502,NLH,20,15,5,0.75,No Limit Hold'em
4441,3/16/2023 12:00:00 pm,Carson Valley Inn,89423,NLH,30,25,5,0.8333333333333334,No Limit Hold'em
4442,3/16/2023 12:00:00 pm,Peppermill Casino,89502,NLH,135,100,35,0.7407407407407407,No Limit Hold'em
4443,1/31/2023 7:00:00 pm,Stagecoach Casino,89003,NLH,60,50,10,0.8333333333333334,No Limit Hold'em
4444,2/28/2023 7:00:00 pm,Stagecoach Casino,89003,NLH,60,50,10,0.8333333333333334,No Limit Hold'em
4445,1/16/2023 11:00:00 am,Borgata Hotel Casino & Spa,8401,NLH,150,125,25,0.8333333333333334,Big Stack
4446,1/17/2023 11:00:00 am,Borgata Hotel Casino & Spa,8401,NLH,180,150,30,0.8333333333333334,Big Stack
4447,1/17/2023 6:00:00 pm,Borgata Hotel Casino & Spa,8401,NLH,150,125,25,0.8333333333333334,Big Stack Turbo Double Green Chip Bounty
4448,1/18/2023 11:00:00 am,Borgata Hotel Casino & Spa,8401,NLH,200,170,30,0.85,Big Stack
4449,1/18/2023 6:00:00 pm,Borgata Hotel Casino & Spa,8401,NLH,230,200,30,0.8695652173913043,"Double Green Chip Bounty Survivor ($1,500 payouts)"
4450,1/19/2023 11:00:00 am,Borgata Hotel Casino & Spa,8401,NLH,300,260,40,0.8666666666666667,Big Stack
4451,1/19/2023 6:00:00 pm,Borgata Hotel Casino & Spa,8401,NLH,225,200,25,0.8888888888888888,Knockout Turbo Black Chip Bounty
4452,1/20/2023 11:00:00 am,Borgata Hotel Casino & Spa,8401,NLH,400,350,50,0.875,Super Stack
4453,1/23/2023 11:00:00 am,Borgata Hotel Casino & Spa,8401,NLH,125,100,25,0.8,"Super Survivor ($1,000 payouts)"
4454,1/24/2023 11:00:00 am,Borgata Hotel Casino & Spa,8401,NLH,180,150,30,0.8333333333333334,"Super Survivor ($1,500 payouts)"
4455,1/24/2023 6:00:00 pm,Borgata Hotel Casino & Spa,8401,NLH,150,125,25,0.8333333333333334,Big Stack Turbo Double Green Chip Bounty
4456,1/25/2023 11:00:00 am,Borgata Hotel Casino & Spa,8401,NLH,230,200,30,0.8695652173913043,"Super Survivor ($2,000 payouts)"
4457,1/25/2023 6:00:00 pm,Borgata Hotel Casino & Spa,8401,NLH,230,200,30,0.8695652173913043,"Double Green Chip Bounty Survivor ($1,500 payouts)"
4458,1/26/2023 11:00:00 am,Borgata Hotel Casino & Spa,8401,NLH,340,300,40,0.8823529411764706,"Super Survivor ($3,000 payouts)"
4459,1/26/2023 6:00:00 pm,Borgata Hotel Casino & Spa,8401,NLH,225,200,25,0.8888888888888888,Knockout Turbo Black Chip Bounty
4460,1/27/2023 11:00:00 am,Borgata Hotel Casino & Spa,8401,NLH,450,400,50,0.8888888888888888,"Super Survivor ($4,000 payouts)"
4461,1/30/2023 11:00:00 am,Borgata Hotel Casino & Spa,8401,NLH,150,125,25,0.8333333333333334,Big Stack Double Green Chip Bounty
4462,1/31/2023 11:00:00 am,Borgata Hotel Casino & Spa,8401,NLH,175,150,25,0.8571428571428571,Big Stack Double Green Chip Bounty
4463,1/31/2023 6:00:00 pm,Borgata Hotel Casino & Spa,8401,NLH,150,125,25,0.8333333333333334,Big Stack Turbo Double Green Chip Bounty
4464,1/15/2023 12:00:00 pm,Sandia Poker Room,87113,NLH,60,40,20,0.6666666666666666,No Limit Hold'em
4465,1/18/2023 7:00:00 pm,Sandia Poker Room,87113,NLH,80,64,16,0.8,No Limit Hold'em Bounty
4466,1/19/2023 7:00:00 pm,Sandia Poker Room,87113,NLH,100,90,10,0.9,No Limit Hold'em
4467,1/22/2023 12:00:00 pm,Sandia Poker Room,87113,NLH,60,40,20,0.6666666666666666,No Limit Hold'em
4468,1/25/2023 7:00:00 pm,Sandia Poker Room,87113,NLH,80,64,16,0.8,No Limit Hold'em Bounty
4469,1/26/2023 7:00:00 pm,Sandia Poker Room,87113,NLH,100,90,10,0.9,No Limit Hold'em
4470,1/29/2023 12:00:00 pm,Sandia Poker Room,87113,NLH,60,40,20,0.6666666666666666,No Limit Hold'em
4471,2/01/2023 7:00:00 pm,Sandia Poker Room,87113,NLH,80,64,16,0.8,No Limit Hold'em Bounty
4472,2/02/2023 7:00:00 pm,Sandia Poker Room,87113,NLH,100,90,10,0.9,No Limit Hold'em
4473,2/05/2023 12:00:00 pm,Sandia Poker Room,87113,NLH,60,40,20,0.6666666666666666,No Limit Hold'em
4474,2/08/2023 7:00:00 pm,Sandia Poker Room,87113,NLH,80,64,16,0.8,No Limit Hold'em Bounty
4475,2/09/2023 7:00:00 pm,Sandia Poker Room,87113,NLH,100,90,10,0.9,No Limit Hold'em
4476,2/12/2023 12:00:00 pm,Sandia Poker Room,87113,NLH,60,40,20,0.6666666666666666,No Limit Hold'em
4477,2/15/2023 7:00:00 pm,Sandia Poker Room,87113,NLH,80,64,16,0.8,No Limit Hold'em Bounty
4478,2/16/2023 7:00:00 pm,Sandia Poker Room,87113,NLH,100,90,10,0.9,No Limit Hold'em
4479,2/19/2023 12:00:00 pm,Sandia Poker Room,87113,NLH,60,40,20,0.6666666666666666,No Limit Hold'em
4480,2/22/2023 7:00:00 pm,Sandia Poker Room,87113,NLH,80,64,16,0.8,No Limit Hold'em Bounty
4481,2/23/2023 7:00:00 pm,Sandia Poker Room,87113,NLH,100,90,10,0.9,No Limit Hold'em
4482,2/26/2023 12:00:00 pm,Sandia Poker Room,87113,NLH,60,40,20,0.6666666666666666,No Limit Hold'em
4483,3/01/2023 7:00:00 pm,Sandia Poker Room,87113,NLH,80,64,16,0.8,No Limit Hold'em Bounty
4484,3/02/2023 7:00:00 pm,Sandia Poker Room,87113,NLH,100,90,10,0.9,No Limit Hold'em
4485,3/05/2023 12:00:00 pm,Sandia Poker Room,87113,NLH,60,40,20,0.6666666666666666,No Limit Hold'em
4486,3/08/2023 7:00:00 pm,Sandia Poker Room,87113,NLH,80,64,16,0.8,No Limit Hold'em Bounty
4487,3/09/2023 7:00:00 pm,Sandia Poker Room,87113,NLH,100,90,10,0.9,No Limit Hold'em
4488,3/12/2023 12:00:00 pm,Sandia Poker Room,87113,NLH,60,40,20,0.6666666666666666,No Limit Hold'em
4489,3/15/2023 7:00:00 pm,Sandia Poker Room,87113,NLH,80,64,16,0.8,No Limit Hold'em Bounty
4490,1/15/2023 12:00:00 pm,Turning Stone Casino,13478,NLH,125,100,25,0.8,Single Table Winner-Take-All NLH (9-player max)
4491,1/15/2023 2:00:00 pm,Turning Stone Casino,13478,NLH,175,140,35,0.8,WSOP Satellite to ME Satellite
4492,1/15/2023 6:15:00 pm,Resorts World Catskills,12701,NLH,100,78,22,0.78,Mega Stack Turbo
4493,1/15/2023 7:00:00 pm,Turning Stone Casino,13478,NLH,125,100,25,0.8,Single-Table Winner-Take-All NLH (8-player max)
4494,1/16/2023 12:00:00 pm,Turning Stone Casino,13478,NLH,125,100,25,0.8,Single Table Winner-Take-All NLH (9-player max)
4495,1/16/2023 6:45:00 pm,Rivers Casino & Resort at Mohawk Harbor,12305,NLH,200,160,40,0.8,$10K NLH
4496,1/16/2023 7:00:00 pm,Turning Stone Casino,13478,NLH,125,100,25,0.8,Single-Table Winner-Take-All NLH (8-player max)
4497,1/17/2023 10:15:00 am,Resorts World Catskills,12701,NLH,150,123,27,0.82,Green Chip Bounty
4498,1/17/2023 12:00:00 pm,Turning Stone Casino,13478,NLH,125,100,25,0.8,Single Table Winner-Take-All NLH (9-player max)
4499,1/17/2023 7:00:00 pm,Turning Stone Casino,13478,NLH,125,100,25,0.8,Single-Table Winner-Take-All NLH (8-player max)
4500,1/18/2023 12:00:00 pm,Turning Stone Casino,13478,NLH,125,100,25,0.8,Single Table Winner-Take-All NLH (9-player max)
4501,1/18/2023 6:15:00 pm,Resorts World Catskills,12701,NLH,150,123,27,0.82,Green Chip Bounty
4502,1/18/2023 7:00:00 pm,Turning Stone Casino,13478,NLH,125,100,25,0.8,Single-Table Winner-Take-All NLH (8-player max)
4503,1/19/2023 10:15:00 am,Resorts World Catskills,12701,NLH,125,100,25,0.8,Mega Stack
4504,1/19/2023 10:15:00 am,Resorts World Catskills,12701,NLH,125,98,27,0.784,Mega Stack NLH
4505,1/19/2023 12:00:00 pm,Turning Stone Casino,13478,NLH,125,100,25,0.8,Single Table Winner-Take-All NLH (9-player max)
4506,1/19/2023 7:00:00 pm,Turning Stone Casino,13478,NLH,125,100,25,0.8,Single-Table Winner-Take-All NLH (8-player max)
4507,1/20/2023 12:00:00 pm,Turning Stone Casino,13478,NLH,125,100,25,0.8,Single Table Winner-Take-All NLH (9-player max)
4508,1/20/2023 7:00:00 pm,Turning Stone Casino,13478,NLH,125,100,25,0.8,Single-Table Winner-Take-All NLH (8-player max)
4509,1/20/2023 7:00:00 pm,Turning Stone Casino,13478,NLH,175,140,35,0.8,WSOP Satellite to ME Satellite
4510,1/21/2023 12:00:00 pm,Turning Stone Casino,13478,NLH,125,100,25,0.8,Single Table Winner-Take-All NLH (9-player max)
4511,1/21/2023 12:00:00 pm,Turning Stone Casino,13478,NLH,175,140,35,0.8,WSOP Satellite to ME Satellite
4512,1/21/2023 1:00:00 pm,Turning Stone Casino,13478,NLH,175,150,25,0.8571428571428571,Double Green Chip Bounty
4513,1/21/2023 7:00:00 pm,Turning Stone Casino,13478,NLH,125,100,25,0.8,Single-Table Winner-Take-All NLH (8-player max)
4514,1/21/2023 7:00:00 pm,Turning Stone Casino,13478,NLH,175,140,35,0.8,WSOP Satellite to ME Satellite
4515,1/22/2023 12:00:00 pm,Turning Stone Casino,13478,NLH,125,100,25,0.8,Single Table Winner-Take-All NLH (9-player max)
4516,1/22/2023 2:00:00 pm,Turning Stone Casino,13478,NLH,175,140,35,0.8,WSOP Satellite to ME Satellite
4517,1/22/2023 6:15:00 pm,Resorts World Catskills,12701,NLH,100,78,22,0.78,Mega Stack Turbo
4518,1/22/2023 7:00:00 pm,Turning Stone Casino,13478,NLH,125,100,25,0.8,Single-Table Winner-Take-All NLH (8-player max)
4519,1/23/2023 12:00:00 pm,Turning Stone Casino,13478,NLH,125,100,25,0.8,Single Table Winner-Take-All NLH (9-player max)
4520,1/23/2023 6:45:00 pm,Rivers Casino & Resort at Mohawk Harbor,12305,NLH,200,160,40,0.8,$10K NLH
4521,1/23/2023 7:00:00 pm,Turning Stone Casino,13478,NLH,125,100,25,0.8,Single-Table Winner-Take-All NLH (8-player max)
4522,1/24/2023 10:15:00 am,Resorts World Catskills,12701,NLH,150,123,27,0.82,Green Chip Bounty
4523,1/24/2023 12:00:00 pm,Turning Stone Casino,13478,NLH,125,100,25,0.8,Single Table Winner-Take-All NLH (9-player max)
4524,1/24/2023 7:00:00 pm,Turning Stone Casino,13478,NLH,125,100,25,0.8,Single-Table Winner-Take-All NLH (8-player max)
4525,1/25/2023 12:00:00 pm,Turning Stone Casino,13478,NLH,125,100,25,0.8,Single Table Winner-Take-All NLH (9-player max)
4526,1/25/2023 6:15:00 pm,Resorts World Catskills,12701,NLH,150,123,27,0.82,Green Chip Bounty
4527,1/25/2023 7:00:00 pm,Turning Stone Casino,13478,NLH,125,100,25,0.8,Single-Table Winner-Take-All NLH (8-player max)
4528,1/26/2023 10:15:00 am,Resorts World Catskills,12701,NLH,125,100,25,0.8,Mega Stack
4529,1/26/2023 10:15:00 am,Resorts World Catskills,12701,NLH,125,98,27,0.784,Mega Stack NLH
4530,1/26/2023 12:00:00 pm,Turning Stone Casino,13478,NLH,125,100,25,0.8,Single Table Winner-Take-All NLH (9-player max)
4531,1/26/2023 7:00:00 pm,Turning Stone Casino,13478,NLH,125,100,25,0.8,Single-Table Winner-Take-All NLH (8-player max)
4532,1/27/2023 12:00:00 pm,Turning Stone Casino,13478,NLH,125,100,25,0.8,Single Table Winner-Take-All NLH (9-player max)
4533,1/27/2023 7:00:00 pm,Turning Stone Casino,13478,NLH,125,100,25,0.8,Single-Table Winner-Take-All NLH (8-player max)
4534,1/27/2023 7:00:00 pm,Turning Stone Casino,13478,NLH,175,140,35,0.8,WSOP Satellite to ME Satellite
4535,1/28/2023 11:15:00 am,Resorts World Catskills,12701,NLH,400,345,55,0.8625,Black Chip Bounty
4536,1/28/2023 12:00:00 pm,Turning Stone Casino,13478,NLH,125,100,25,0.8,Single Table Winner-Take-All NLH (9-player max)
4537,1/28/2023 12:00:00 pm,Turning Stone Casino,13478,NLH,175,140,35,0.8,WSOP Satellite to ME Satellite
4538,1/28/2023 7:00:00 pm,Turning Stone Casino,13478,NLH,125,100,25,0.8,Single-Table Winner-Take-All NLH (8-player max)
4539,1/28/2023 7:00:00 pm,Turning Stone Casino,13478,NLH,175,140,35,0.8,WSOP Satellite to ME Satellite
4540,1/29/2023 12:00:00 pm,Turning Stone Casino,13478,NLH,125,100,25,0.8,Single Table Winner-Take-All NLH (9-player max)
4541,1/29/2023 2:00:00 pm,Turning Stone Casino,13478,NLH,175,140,35,0.8,WSOP Satellite to ME Satellite
4542,1/29/2023 6:15:00 pm,Resorts World Catskills,12701,NLH,100,78,22,0.78,Mega Stack Turbo
4543,1/29/2023 7:00:00 pm,Turning Stone Casino,13478,NLH,125,100,25,0.8,Single-Table Winner-Take-All NLH (8-player max)
4544,1/30/2023 12:00:00 pm,Turning Stone Casino,13478,NLH,125,100,25,0.8,Single Table Winner-Take-All NLH (9-player max)
4545,1/30/2023 6:45:00 pm,Rivers Casino & Resort at Mohawk Harbor,12305,NLH,200,160,40,0.8,$10K NLH
4546,1/30/2023 7:00:00 pm,Turning Stone Casino,13478,NLH,125,100,25,0.8,Single-Table Winner-Take-All NLH (8-player max)
4547,1/31/2023 10:15:00 am,Resorts World Catskills,12701,NLH,150,123,27,0.82,Green Chip Bounty
4548,1/31/2023 12:00:00 pm,Turning Stone Casino,13478,NLH,125,100,25,0.8,Single Table Winner-Take-All NLH (9-player max)
4549,1/31/2023 7:00:00 pm,Turning Stone Casino,13478,NLH,125,100,25,0.8,Single-Table Winner-Take-All NLH (8-player max)
4550,1/31/2023 7:00:00 pm,Turning Stone Casino,13478,NLH,135,105,30,0.7777777777777778,$5K Green Chip Bounty
4551,2/01/2023 12:00:00 pm,Turning Stone Casino,13478,NLH,125,100,25,0.8,Single Table Winner-Take-All NLH (9-player max)
4552,2/01/2023 6:15:00 pm,Resorts World Catskills,12701,NLH,150,123,27,0.82,Green Chip Bounty
4553,2/01/2023 7:00:00 pm,Turning Stone Casino,13478,NLH,125,100,25,0.8,Single-Table Winner-Take-All NLH (8-player max)
4554,2/02/2023 10:15:00 am,Resorts World Catskills,12701,NLH,125,100,25,0.8,Mega Stack
4555,2/02/2023 10:15:00 am,Resorts World Catskills,12701,NLH,125,98,27,0.784,Mega Stack NLH
4556,2/02/2023 12:00:00 pm,Turning Stone Casino,13478,NLH,125,100,25,0.8,Single Table Winner-Take-All NLH (9-player max)
4557,2/02/2023 7:00:00 pm,Turning Stone Casino,13478,NLH,125,100,25,0.8,Single-Table Winner-Take-All NLH (8-player max)
4558,2/03/2023 12:00:00 pm,Turning Stone Casino,13478,NLH,125,100,25,0.8,Single Table Winner-Take-All NLH (9-player max)
4559,2/03/2023 7:00:00 pm,Turning Stone Casino,13478,NLH,125,100,25,0.8,Single-Table Winner-Take-All NLH (8-player max)
4560,2/03/2023 7:00:00 pm,Turning Stone Casino,13478,NLH,175,140,35,0.8,WSOP Satellite to ME Satellite
4561,2/04/2023 12:00:00 pm,Turning Stone Casino,13478,NLH,125,100,25,0.8,Single Table Winner-Take-All NLH (9-player max)
4562,2/04/2023 12:00:00 pm,Turning Stone Casino,13478,NLH,175,140,35,0.8,WSOP Satellite to ME Satellite
4563,2/04/2023 7:00:00 pm,Turning Stone Casino,13478,NLH,125,100,25,0.8,Single-Table Winner-Take-All NLH (8-player max)
4564,2/04/2023 7:00:00 pm,Turning Stone Casino,13478,NLH,175,140,35,0.8,WSOP Satellite to ME Satellite
4565,2/05/2023 12:00:00 pm,Turning Stone Casino,13478,NLH,125,100,25,0.8,Single Table Winner-Take-All NLH (9-player max)
4566,2/05/2023 2:00:00 pm,Turning Stone Casino,13478,NLH,175,140,35,0.8,WSOP Satellite to ME Satellite
4567,2/05/2023 6:15:00 pm,Resorts World Catskills,12701,NLH,100,78,22,0.78,Mega Stack Turbo
4568,2/05/2023 7:00:00 pm,Turning Stone Casino,13478,NLH,125,100,25,0.8,Single-Table Winner-Take-All NLH (8-player max)
4569,2/06/2023 12:00:00 pm,Turning Stone Casino,13478,NLH,125,100,25,0.8,Single Table Winner-Take-All NLH (9-player max)
4570,2/06/2023 6:45:00 pm,Rivers Casino & Resort at Mohawk Harbor,12305,NLH,200,160,40,0.8,$10K NLH
4571,2/06/2023 7:00:00 pm,Turning Stone Casino,13478,NLH,125,100,25,0.8,Single-Table Winner-Take-All NLH (8-player max)
4572,2/07/2023 10:15:00 am,Resorts World Catskills,12701,NLH,150,123,27,0.82,Green Chip Bounty
4573,2/07/2023 12:00:00 pm,Turning Stone Casino,13478,NLH,125,100,25,0.8,Single Table Winner-Take-All NLH (9-player max)
4574,2/07/2023 7:00:00 pm,Turning Stone Casino,13478,NLH,125,100,25,0.8,Single-Table Winner-Take-All NLH (8-player max)
4575,2/08/2023 12:00:00 pm,Turning Stone Casino,13478,NLH,125,100,25,0.8,Single Table Winner-Take-All NLH (9-player max)
4576,2/08/2023 6:15:00 pm,Resorts World Catskills,12701,NLH,150,123,27,0.82,Green Chip Bounty
4577,2/08/2023 7:00:00 pm,Turning Stone Casino,13478,NLH,125,100,25,0.8,Single-Table Winner-Take-All NLH (8-player max)
4578,2/09/2023 10:15:00 am,Resorts World Catskills,12701,NLH,125,100,25,0.8,Mega Stack
4579,2/09/2023 10:15:00 am,Resorts World Catskills,12701,NLH,125,98,27,0.784,Mega Stack NLH
4580,2/09/2023 12:00:00 pm,Turning Stone Casino,13478,NLH,125,100,25,0.8,Single Table Winner-Take-All NLH (9-player max)
4581,2/09/2023 7:00:00 pm,Turning Stone Casino,13478,NLH,125,100,25,0.8,Single-Table Winner-Take-All NLH (8-player max)
4582,2/10/2023 12:00:00 pm,Turning Stone Casino,13478,NLH,125,100,25,0.8,Single Table Winner-Take-All NLH (9-player max)
4583,2/10/2023 7:00:00 pm,Turning Stone Casino,13478,NLH,125,100,25,0.8,Single-Table Winner-Take-All NLH (8-player max)
4584,2/10/2023 7:00:00 pm,Turning Stone Casino,13478,NLH,175,140,35,0.8,WSOP Satellite to ME Satellite
4585,2/11/2023 12:00:00 pm,Turning Stone Casino,13478,NLH,125,100,25,0.8,Single Table Winner-Take-All NLH (9-player max)
4586,2/11/2023 12:00:00 pm,Turning Stone Casino,13478,NLH,175,140,35,0.8,WSOP Satellite to ME Satellite
4587,2/11/2023 7:00:00 pm,Turning Stone Casino,13478,NLH,125,100,25,0.8,Single-Table Winner-Take-All NLH (8-player max)
4588,2/11/2023 7:00:00 pm,Turning Stone Casino,13478,NLH,175,140,35,0.8,WSOP Satellite to ME Satellite
4589,2/12/2023 12:00:00 pm,Turning Stone Casino,13478,NLH,125,100,25,0.8,Single Table Winner-Take-All NLH (9-player max)
4590,2/12/2023 2:00:00 pm,Turning Stone Casino,13478,NLH,175,140,35,0.8,WSOP Satellite to ME Satellite
4591,2/12/2023 6:15:00 pm,Resorts World Catskills,12701,NLH,100,78,22,0.78,Mega Stack Turbo
4592,2/12/2023 7:00:00 pm,Turning Stone Casino,13478,NLH,125,100,25,0.8,Single-Table Winner-Take-All NLH (8-player max)
4593,2/13/2023 12:00:00 pm,Turning Stone Casino,13478,NLH,125,100,25,0.8,Single Table Winner-Take-All NLH (9-player max)
4594,2/13/2023 6:45:00 pm,Rivers Casino & Resort at Mohawk Harbor,12305,NLH,200,160,40,0.8,$10K NLH
4595,2/13/2023 7:00:00 pm,Turning Stone Casino,13478,NLH,125,100,25,0.8,Single-Table Winner-Take-All NLH (8-player max)
4596,2/14/2023 10:15:00 am,Resorts World Catskills,12701,NLH,150,123,27,0.82,Green Chip Bounty
4597,2/14/2023 12:00:00 pm,Turning Stone Casino,13478,NLH,125,100,25,0.8,Single Table Winner-Take-All NLH (9-player max)
4598,2/14/2023 7:00:00 pm,Turning Stone Casino,13478,NLH,125,100,25,0.8,Single-Table Winner-Take-All NLH (8-player max)
4599,2/15/2023 12:00:00 pm,Turning Stone Casino,13478,NLH,125,100,25,0.8,Single Table Winner-Take-All NLH (9-player max)
4600,2/15/2023 6:15:00 pm,Resorts World Catskills,12701,NLH,150,123,27,0.82,Green Chip Bounty
4601,2/15/2023 7:00:00 pm,Turning Stone Casino,13478,NLH,125,100,25,0.8,Single-Table Winner-Take-All NLH (8-player max)
4602,2/16/2023 10:15:00 am,Resorts World Catskills,12701,NLH,125,100,25,0.8,Mega Stack
4603,2/16/2023 10:15:00 am,Resorts World Catskills,12701,NLH,125,98,27,0.784,Mega Stack NLH
4604,2/16/2023 12:00:00 pm,Turning Stone Casino,13478,NLH,125,100,25,0.8,Single Table Winner-Take-All NLH (9-player max)
4605,2/16/2023 7:00:00 pm,Turning Stone Casino,13478,NLH,125,100,25,0.8,Single-Table Winner-Take-All NLH (8-player max)
4606,2/17/2023 12:00:00 pm,Turning Stone Casino,13478,NLH,125,100,25,0.8,Single Table Winner-Take-All NLH (9-player max)
4607,2/17/2023 7:00:00 pm,Turning Stone Casino,13478,NLH,125,100,25,0.8,Single-Table Winner-Take-All NLH (8-player max)
4608,2/17/2023 7:00:00 pm,Turning Stone Casino,13478,NLH,175,140,35,0.8,WSOP Satellite to ME Satellite
4609,2/18/2023 12:00:00 pm,Turning Stone Casino,13478,NLH,125,100,25,0.8,Single Table Winner-Take-All NLH (9-player max)
4610,2/18/2023 12:00:00 pm,Turning Stone Casino,13478,NLH,175,140,35,0.8,WSOP Satellite to ME Satellite
4611,2/18/2023 7:00:00 pm,Turning Stone Casino,13478,NLH,125,100,25,0.8,Single-Table Winner-Take-All NLH (8-player max)
4612,2/18/2023 7:00:00 pm,Turning Stone Casino,13478,NLH,175,140,35,0.8,WSOP Satellite to ME Satellite
4613,2/19/2023 12:00:00 pm,Turning Stone Casino,13478,NLH,125,100,25,0.8,Single Table Winner-Take-All NLH (9-player max)
4614,2/19/2023 1:00:00 pm,Turning Stone Casino,13478,NLH,1400,1300,100,0.9285714285714286,WSOP Main Event Satellite
4615,2/19/2023 6:15:00 pm,Resorts World Catskills,12701,NLH,100,78,22,0.78,Mega Stack Turbo
4616,2/19/2023 7:00:00 pm,Turning Stone Casino,13478,NLH,125,100,25,0.8,Single-Table Winner-Take-All NLH (8-player max)
4617,2/20/2023 12:00:00 pm,Turning Stone Casino,13478,NLH,125,100,25,0.8,Single Table Winner-Take-All NLH (9-player max)
4618,2/20/2023 6:45:00 pm,Rivers Casino & Resort at Mohawk Harbor,12305,NLH,200,160,40,0.8,$10K NLH
4619,2/20/2023 7:00:00 pm,Turning Stone Casino,13478,NLH,125,100,25,0.8,Single-Table Winner-Take-All NLH (8-player max)
4620,2/21/2023 10:15:00 am,Resorts World Catskills,12701,NLH,150,123,27,0.82,Green Chip Bounty
4621,2/21/2023 12:00:00 pm,Turning Stone Casino,13478,NLH,125,100,25,0.8,Single Table Winner-Take-All NLH (9-player max)
4622,2/21/2023 7:00:00 pm,Turning Stone Casino,13478,NLH,125,100,25,0.8,Single-Table Winner-Take-All NLH (8-player max)
4623,2/22/2023 12:00:00 pm,Turning Stone Casino,13478,NLH,125,100,25,0.8,Single Table Winner-Take-All NLH (9-player max)
4624,2/22/2023 6:15:00 pm,Resorts World Catskills,12701,NLH,150,123,27,0.82,Green Chip Bounty
4625,2/22/2023 7:00:00 pm,Turning Stone Casino,13478,NLH,125,100,25,0.8,Single-Table Winner-Take-All NLH (8-player max)
4626,2/23/2023 10:15:00 am,Resorts World Catskills,12701,NLH,125,100,25,0.8,Mega Stack
4627,2/23/2023 10:15:00 am,Resorts World Catskills,12701,NLH,125,98,27,0.784,Mega Stack NLH
4628,2/23/2023 12:00:00 pm,Turning Stone Casino,13478,NLH,125,100,25,0.8,Single Table Winner-Take-All NLH (9-player max)
4629,2/23/2023 7:00:00 pm,Turning Stone Casino,13478,NLH,125,100,25,0.8,Single-Table Winner-Take-All NLH (8-player max)
4630,2/24/2023 12:00:00 pm,Turning Stone Casino,13478,NLH,125,100,25,0.8,Single Table Winner-Take-All NLH (9-player max)
4631,2/24/2023 7:00:00 pm,Turning Stone Casino,13478,NLH,125,100,25,0.8,Single-Table Winner-Take-All NLH (8-player max)
4632,2/24/2023 7:00:00 pm,Turning Stone Casino,13478,NLH,175,140,35,0.8,WSOP Satellite to ME Satellite
4633,2/25/2023 12:00:00 pm,Turning Stone Casino,13478,NLH,125,100,25,0.8,Single Table Winner-Take-All NLH (9-player max)
4634,2/25/2023 12:00:00 pm,Turning Stone Casino,13478,NLH,175,140,35,0.8,WSOP Satellite to ME Satellite
4635,2/25/2023 7:00:00 pm,Turning Stone Casino,13478,NLH,125,100,25,0.8,Single-Table Winner-Take-All NLH (8-player max)
4636,2/25/2023 7:00:00 pm,Turning Stone Casino,13478,NLH,175,140,35,0.8,WSOP Satellite to ME Satellite
4637,2/26/2023 12:00:00 pm,Turning Stone Casino,13478,NLH,125,100,25,0.8,Single Table Winner-Take-All NLH (9-player max)
4638,2/26/2023 6:15:00 pm,Resorts World Catskills,12701,NLH,100,78,22,0.78,Mega Stack Turbo
4639,2/26/2023 7:00:00 pm,Turning Stone Casino,13478,NLH,125,100,25,0.8,Single-Table Winner-Take-All NLH (8-player max)
4640,2/27/2023 12:00:00 pm,Turning Stone Casino,13478,NLH,125,100,25,0.8,Single Table Winner-Take-All NLH (9-player max)
4641,2/27/2023 6:45:00 pm,Rivers Casino & Resort at Mohawk Harbor,12305,NLH,200,160,40,0.8,$10K NLH
4642,2/27/2023 7:00:00 pm,Turning Stone Casino,13478,NLH,125,100,25,0.8,Single-Table Winner-Take-All NLH (8-player max)
4643,2/28/2023 10:15:00 am,Resorts World Catskills,12701,NLH,150,123,27,0.82,Green Chip Bounty
4644,2/28/2023 12:00:00 pm,Turning Stone Casino,13478,NLH,125,100,25,0.8,Single Table Winner-Take-All NLH (9-player max)
4645,2/28/2023 7:00:00 pm,Turning Stone Casino,13478,NLH,125,100,25,0.8,Single-Table Winner-Take-All NLH (8-player max)
4646,3/01/2023 12:00:00 pm,Turning Stone Casino,13478,NLH,125,100,25,0.8,Single Table Winner-Take-All NLH (9-player max)
4647,3/01/2023 6:15:00 pm,Resorts World Catskills,12701,NLH,150,123,27,0.82,Green Chip Bounty
4648,3/01/2023 7:00:00 pm,Turning Stone Casino,13478,NLH,125,100,25,0.8,Single-Table Winner-Take-All NLH (8-player max)
4649,3/02/2023 10:15:00 am,Resorts World Catskills,12701,NLH,125,100,25,0.8,Mega Stack
4650,3/02/2023 10:15:00 am,Resorts World Catskills,12701,NLH,125,98,27,0.784,Mega Stack NLH
4651,3/02/2023 12:00:00 pm,Turning Stone Casino,13478,NLH,125,100,25,0.8,Single Table Winner-Take-All NLH (9-player max)
4652,3/02/2023 7:00:00 pm,Turning Stone Casino,13478,NLH,125,100,25,0.8,Single-Table Winner-Take-All NLH (8-player max)
4653,3/03/2023 12:00:00 pm,Turning Stone Casino,13478,NLH,125,100,25,0.8,Single Table Winner-Take-All NLH (9-player max)
4654,3/03/2023 7:00:00 pm,Turning Stone Casino,13478,NLH,175,140,35,0.8,WSOP Satellite to ME Satellite
4655,3/03/2023 7:00:00 pm,Turning Stone Casino,13478,NLH,125,100,25,0.8,Single-Table Winner-Take-All NLH (8-player max)
4656,3/04/2023 12:00:00 pm,Turning Stone Casino,13478,NLH,175,140,35,0.8,WSOP Satellite to ME Satellite
4657,3/04/2023 12:00:00 pm,Turning Stone Casino,13478,NLH,125,100,25,0.8,Single Table Winner-Take-All NLH (9-player max)
4658,3/04/2023 7:00:00 pm,Turning Stone Casino,13478,NLH,175,140,35,0.8,WSOP Satellite to ME Satellite
4659,3/04/2023 7:00:00 pm,Turning Stone Casino,13478,NLH,125,100,25,0.8,Single-Table Winner-Take-All NLH (8-player max)
4660,3/05/2023 12:00:00 pm,Turning Stone Casino,13478,NLH,125,100,25,0.8,Single Table Winner-Take-All NLH (9-player max)
4661,3/05/2023 6:15:00 pm,Resorts World Catskills,12701,NLH,100,78,22,0.78,Mega Stack Turbo
4662,3/05/2023 7:00:00 pm,Turning Stone Casino,13478,NLH,125,100,25,0.8,Single-Table Winner-Take-All NLH (8-player max)
4663,3/06/2023 12:00:00 pm,Turning Stone Casino,13478,NLH,125,100,25,0.8,Single Table Winner-Take-All NLH (9-player max)
4664,3/06/2023 6:45:00 pm,Rivers Casino & Resort at Mohawk Harbor,12305,NLH,200,160,40,0.8,$10K NLH
4665,3/06/2023 7:00:00 pm,Turning Stone Casino,13478,NLH,125,100,25,0.8,Single-Table Winner-Take-All NLH (8-player max)
4666,3/07/2023 10:15:00 am,Resorts World Catskills,12701,NLH,150,123,27,0.82,Green Chip Bounty
4667,3/07/2023 12:00:00 pm,Turning Stone Casino,13478,NLH,125,100,25,0.8,Single Table Winner-Take-All NLH (9-player max)
4668,3/07/2023 7:00:00 pm,Turning Stone Casino,13478,NLH,125,100,25,0.8,Single-Table Winner-Take-All NLH (8-player max)
4669,3/08/2023 12:00:00 pm,Turning Stone Casino,13478,NLH,125,100,25,0.8,Single Table Winner-Take-All NLH (9-player max)
4670,3/08/2023 6:15:00 pm,Resorts World Catskills,12701,NLH,150,123,27,0.82,Green Chip Bounty
4671,3/08/2023 7:00:00 pm,Turning Stone Casino,13478,NLH,125,100,25,0.8,Single-Table Winner-Take-All NLH (8-player max)
4672,3/09/2023 10:15:00 am,Resorts World Catskills,12701,NLH,125,100,25,0.8,Mega Stack
4673,3/09/2023 10:15:00 am,Resorts World Catskills,12701,NLH,125,98,27,0.784,Mega Stack NLH
4674,3/09/2023 12:00:00 pm,Turning Stone Casino,13478,NLH,125,100,25,0.8,Single Table Winner-Take-All NLH (9-player max)
4675,3/09/2023 7:00:00 pm,Turning Stone Casino,13478,NLH,125,100,25,0.8,Single-Table Winner-Take-All NLH (8-player max)
4676,3/10/2023 12:00:00 pm,Turning Stone Casino,13478,NLH,125,100,25,0.8,Single Table Winner-Take-All NLH (9-player max)
4677,3/10/2023 7:00:00 pm,Turning Stone Casino,13478,NLH,175,140,35,0.8,WSOP Satellite to ME Satellite
4678,3/10/2023 7:00:00 pm,Turning Stone Casino,13478,NLH,125,100,25,0.8,Single-Table Winner-Take-All NLH (8-player max)
4679,3/11/2023 12:00:00 pm,Turning Stone Casino,13478,NLH,175,140,35,0.8,WSOP Satellite to ME Satellite
4680,3/11/2023 12:00:00 pm,Turning Stone Casino,13478,NLH,125,100,25,0.8,Single Table Winner-Take-All NLH (9-player max)
4681,3/11/2023 7:00:00 pm,Turning Stone Casino,13478,NLH,175,140,35,0.8,WSOP Satellite to ME Satellite
4682,3/11/2023 7:00:00 pm,Turning Stone Casino,13478,NLH,125,100,25,0.8,Single-Table Winner-Take-All NLH (8-player max)
4683,3/12/2023 12:00:00 pm,Turning Stone Casino,13478,NLH,125,100,25,0.8,Single Table Winner-Take-All NLH (9-player max)
4684,3/12/2023 6:15:00 pm,Resorts World Catskills,12701,NLH,100,78,22,0.78,Mega Stack Turbo
4685,3/12/2023 7:00:00 pm,Turning Stone Casino,13478,NLH,125,100,25,0.8,Single-Table Winner-Take-All NLH (8-player max)
4686,3/13/2023 12:00:00 pm,Turning Stone Casino,13478,NLH,125,100,25,0.8,Single Table Winner-Take-All NLH (9-player max)
4687,3/13/2023 6:45:00 pm,Rivers Casino & Resort at Mohawk Harbor,12305,NLH,200,160,40,0.8,$10K NLH
4688,3/13/2023 7:00:00 pm,Turning Stone Casino,13478,NLH,125,100,25,0.8,Single-Table Winner-Take-All NLH (8-player max)
4689,3/14/2023 10:15:00 am,Resorts World Catskills,12701,NLH,150,123,27,0.82,Green Chip Bounty
4690,3/14/2023 12:00:00 pm,Turning Stone Casino,13478,NLH,125,100,25,0.8,Single Table Winner-Take-All NLH (9-player max)
4691,3/14/2023 7:00:00 pm,Turning Stone Casino,13478,NLH,125,100,25,0.8,Single-Table Winner-Take-All NLH (8-player max)
4692,3/15/2023 12:00:00 pm,Turning Stone Casino,13478,NLH,125,100,25,0.8,Single Table Winner-Take-All NLH (9-player max)
4693,3/15/2023 6:15:00 pm,Resorts World Catskills,12701,NLH,150,123,27,0.82,Green Chip Bounty
4694,3/15/2023 7:00:00 pm,Turning Stone Casino,13478,NLH,125,100,25,0.8,Single-Table Winner-Take-All NLH (8-player max)
4695,3/16/2023 10:15:00 am,Resorts World Catskills,12701,NLH,125,100,25,0.8,Mega Stack
4696,3/16/2023 10:15:00 am,Resorts World Catskills,12701,NLH,125,98,27,0.784,Mega Stack NLH
4697,3/16/2023 12:00:00 pm,Turning Stone Casino,13478,NLH,125,100,25,0.8,Single Table Winner-Take-All NLH (9-player max)
4698,1/15/2023 12:15:00 pm,JACK Cleveland Casino,44113,NLH,250,197,53,0.788,$10K NLH
4699,1/16/2023 12:15:00 pm,JACK Cleveland Casino,44113,NLH,350,300,50,0.8571428571428571,$25K MLK Day
4700,1/16/2023 12:15:00 pm,JACK Cleveland Casino,44113,NLH,300,240,60,0.8,$20K Seniors (50+)
4701,1/17/2023 11:15:00 am,JACK Cleveland Casino,44113,NLH,160,120,40,0.75,"$3,600 NLH Survivor"
4702,1/18/2023 11:15:00 am,JACK Cleveland Casino,44113,NLH,160,120,40,0.75,$3K NLH
4703,1/19/2023 3:15:00 pm,JACK Cleveland Casino,44113,NLH,300,240,60,0.8,$10K JACK Thursday 300
4704,1/20/2023 11:15:00 am,JACK Cleveland Casino,44113,NLH,200,155,45,0.775,$5K Friday 200
4705,1/21/2023 12:15:00 pm,JACK Cleveland Casino,44113,NLH,220,175,45,0.7954545454545454,$5K Double Green Chip Bounty
4706,1/21/2023 4:15:00 pm,JACK Cleveland Casino,44113,NLH,140,112,28,0.8,MSPT Main Event Satellite
4707,1/22/2023 12:15:00 pm,JACK Cleveland Casino,44113,NLH,250,197,53,0.788,$10K NLH
4708,1/23/2023 11:15:00 am,JACK Cleveland Casino,44113,NLH,160,120,40,0.75,$3K NLH
4709,1/24/2023 11:15:00 am,JACK Cleveland Casino,44113,NLH,160,120,40,0.75,"$3,600 NLH Survivor"
4710,1/25/2023 11:15:00 am,JACK Cleveland Casino,44113,NLH,160,120,40,0.75,$3K NLH
4711,1/26/2023 3:15:00 pm,JACK Cleveland Casino,44113,NLH,300,240,60,0.8,$10K JACK Thursday 300
4712,1/27/2023 11:15:00 am,JACK Cleveland Casino,44113,NLH,200,155,45,0.775,$5K Friday 200
4713,1/28/2023 12:15:00 pm,JACK Cleveland Casino,44113,NLH,220,175,45,0.7954545454545454,$5K Double Green Chip Bounty
4714,1/28/2023 4:15:00 pm,JACK Cleveland Casino,44113,NLH,140,112,28,0.8,MSPT Main Event Satellite
4715,1/29/2023 12:15:00 pm,JACK Cleveland Casino,44113,NLH,250,197,53,0.788,$10K NLH
4716,1/30/2023 11:15:00 am,JACK Cleveland Casino,44113,NLH,160,120,40,0.75,$3K NLH
4717,1/31/2023 11:15:00 am,JACK Cleveland Casino,44113,NLH,160,120,40,0.75,"$3,600 NLH Survivor"
4718,1/15/2023 12:15:00 pm,Hollywood Casino Columbus,43228,NLH,300,255,45,0.85,$30K Monthly Mega
4719,1/16/2023 12:15:00 pm,Hollywood Casino Columbus,43228,NLH,60,45,15,0.75,$1K Turbo
4720,1/16/2023 7:15:00 pm,Hollywood Casino Columbus,43228,NLH,100,75,25,0.75,Green Chip Bounty
4721,1/17/2023 12:15:00 pm,Hollywood Casino Columbus,43228,NLH,60,45,15,0.75,$1K Turbo
4722,1/18/2023 12:15:00 pm,Hollywood Casino Columbus,43228,NLH,60,45,15,0.75,$1K Turbo
4723,1/19/2023 7:15:00 pm,Hollywood Casino Columbus,43228,NLH,100,75,25,0.75,$7K Power Stacks
4724,1/20/2023 12:15:00 pm,Hollywood Casino Columbus,43228,NLH,60,45,15,0.75,$1K Turbo
4725,1/22/2023 12:15:00 pm,Hollywood Casino Columbus,43228,NLH,160,130,30,0.8125,Sunday Super 10K
4726,1/23/2023 12:15:00 pm,Hollywood Casino Columbus,43228,NLH,60,45,15,0.75,$1K Turbo
4727,1/23/2023 7:15:00 pm,Hollywood Casino Columbus,43228,NLH,100,75,25,0.75,Green Chip Bounty
4728,1/24/2023 12:15:00 pm,Hollywood Casino Columbus,43228,NLH,60,45,15,0.75,$1K Turbo
4729,1/25/2023 12:15:00 pm,Hollywood Casino Columbus,43228,NLH,60,45,15,0.75,$1K Turbo
4730,1/26/2023 7:15:00 pm,Hollywood Casino Columbus,43228,NLH,100,75,25,0.75,$7K Power Stacks
4731,1/27/2023 12:15:00 pm,Hollywood Casino Columbus,43228,NLH,60,45,15,0.75,$1K Turbo
4732,1/29/2023 12:15:00 pm,Hollywood Casino Columbus,43228,NLH,160,130,30,0.8125,Sunday Super 10K
4733,1/30/2023 12:15:00 pm,Hollywood Casino Columbus,43228,NLH,60,45,15,0.75,$1K Turbo
4734,1/30/2023 7:15:00 pm,Hollywood Casino Columbus,43228,NLH,100,75,25,0.75,Green Chip Bounty
4735,1/31/2023 12:15:00 pm,Hollywood Casino Columbus,43228,NLH,60,45,15,0.75,$1K Turbo
4736,2/01/2023 12:15:00 pm,Hollywood Casino Columbus,43228,NLH,60,45,15,0.75,$1K Turbo
4737,2/02/2023 7:15:00 pm,Hollywood Casino Columbus,43228,NLH,100,75,25,0.75,$7K Power Stacks
4738,2/03/2023 12:15:00 pm,Hollywood Casino Columbus,43228,NLH,60,45,15,0.75,$1K Turbo
4739,2/05/2023 12:15:00 pm,Hollywood Casino Columbus,43228,NLH,160,130,30,0.8125,Sunday Super 10K
4740,2/06/2023 12:15:00 pm,Hollywood Casino Columbus,43228,NLH,60,45,15,0.75,$1K Turbo
4741,2/06/2023 7:15:00 pm,Hollywood Casino Columbus,43228,NLH,100,75,25,0.75,Green Chip Bounty
4742,2/07/2023 12:15:00 pm,Hollywood Casino Columbus,43228,NLH,60,45,15,0.75,$1K Turbo
4743,2/08/2023 12:15:00 pm,Hollywood Casino Columbus,43228,NLH,60,45,15,0.75,$1K Turbo
4744,2/09/2023 7:15:00 pm,Hollywood Casino Columbus,43228,NLH,100,75,25,0.75,$7K Power Stacks
4745,2/10/2023 12:15:00 pm,Hollywood Casino Columbus,43228,NLH,60,45,15,0.75,$1K Turbo
4746,2/12/2023 12:15:00 pm,Hollywood Casino Columbus,43228,NLH,160,130,30,0.8125,Sunday Super 10K
4747,2/13/2023 12:15:00 pm,Hollywood Casino Columbus,43228,NLH,60,45,15,0.75,$1K Turbo
4748,2/13/2023 7:15:00 pm,Hollywood Casino Columbus,43228,NLH,100,75,25,0.75,Green Chip Bounty
4749,2/14/2023 12:15:00 pm,Hollywood Casino Columbus,43228,NLH,60,45,15,0.75,$1K Turbo
4750,2/15/2023 12:15:00 pm,Hollywood Casino Columbus,43228,NLH,60,45,15,0.75,$1K Turbo
4751,2/16/2023 7:15:00 pm,Hollywood Casino Columbus,43228,NLH,100,75,25,0.75,$7K Power Stacks
4752,2/17/2023 12:15:00 pm,Hollywood Casino Columbus,43228,NLH,60,45,15,0.75,$1K Turbo
4753,2/19/2023 12:15:00 pm,Hollywood Casino Columbus,43228,NLH,300,255,45,0.85,$30K Monthly Mega
4754,2/20/2023 12:15:00 pm,Hollywood Casino Columbus,43228,NLH,60,45,15,0.75,$1K Turbo
4755,2/20/2023 7:15:00 pm,Hollywood Casino Columbus,43228,NLH,100,75,25,0.75,Green Chip Bounty
4756,2/21/2023 12:15:00 pm,Hollywood Casino Columbus,43228,NLH,60,45,15,0.75,$1K Turbo
4757,2/22/2023 12:15:00 pm,Hollywood Casino Columbus,43228,NLH,60,45,15,0.75,$1K Turbo
4758,2/23/2023 7:15:00 pm,Hollywood Casino Columbus,43228,NLH,100,75,25,0.75,$7K Power Stacks
4759,2/24/2023 12:15:00 pm,Hollywood Casino Columbus,43228,NLH,60,45,15,0.75,$1K Turbo
4760,2/26/2023 12:15:00 pm,Hollywood Casino Columbus,43228,NLH,160,130,30,0.8125,Sunday Super 10K
4761,2/27/2023 12:15:00 pm,Hollywood Casino Columbus,43228,NLH,60,45,15,0.75,$1K Turbo
4762,2/27/2023 7:15:00 pm,Hollywood Casino Columbus,43228,NLH,100,75,25,0.75,Green Chip Bounty
4763,2/28/2023 12:15:00 pm,Hollywood Casino Columbus,43228,NLH,60,45,15,0.75,$1K Turbo
4764,3/01/2023 12:15:00 pm,Hollywood Casino Columbus,43228,NLH,60,45,15,0.75,$1K Turbo
4765,3/02/2023 7:15:00 pm,Hollywood Casino Columbus,43228,NLH,100,75,25,0.75,$7K Power Stacks
4766,3/05/2023 12:15:00 pm,Hollywood Casino Columbus,43228,NLH,160,130,30,0.8125,Sunday Super 10K
4767,3/06/2023 12:15:00 pm,Hollywood Casino Columbus,43228,NLH,60,45,15,0.75,$1K Turbo
4768,3/06/2023 7:15:00 pm,Hollywood Casino Columbus,43228,NLH,100,75,25,0.75,Green Chip Bounty
4769,3/07/2023 12:15:00 pm,Hollywood Casino Columbus,43228,NLH,60,45,15,0.75,$1K Turbo
4770,3/08/2023 12:15:00 pm,Hollywood Casino Columbus,43228,NLH,60,45,15,0.75,$1K Turbo
4771,3/09/2023 7:15:00 pm,Hollywood Casino Columbus,43228,NLH,100,75,25,0.75,$7K Power Stacks
4772,3/10/2023 12:15:00 pm,Hollywood Casino Columbus,43228,NLH,60,45,15,0.75,$1K Turbo
4773,3/12/2023 12:15:00 pm,Hollywood Casino Columbus,43228,NLH,160,130,30,0.8125,Sunday Super 10K
4774,3/13/2023 12:15:00 pm,Hollywood Casino Columbus,43228,NLH,60,45,15,0.75,$1K Turbo
4775,3/13/2023 7:15:00 pm,Hollywood Casino Columbus,43228,NLH,100,75,25,0.75,Green Chip Bounty
4776,3/14/2023 12:15:00 pm,Hollywood Casino Columbus,43228,NLH,60,45,15,0.75,$1K Turbo
4777,3/15/2023 12:15:00 pm,Hollywood Casino Columbus,43228,NLH,60,45,15,0.75,$1K Turbo
4778,1/15/2023 2:00:00 pm,Choctaw Casino Durant,74701,NLH,300,240,60,0.8,2022-23 WSOP Circuit Event (Dallas/Oklahoma-Winter) - Event #42 - No Limit Hold'em
4779,1/15/2023 4:00:00 pm,Choctaw Casino Durant,74701,PLCngrs,300,240,60,0.8,2022-23 WSOP Circuit Event (Dallas/Oklahoma-Winter) - Event #43 - Congress
4780,1/15/2023 6:00:00 pm,Choctaw Casino Durant,74701,NLH,200,160,40,0.8,2022-23 WSOP Circuit Event (Dallas/Oklahoma-Winter) - Event #44 - Deep Stack Nightly No-Limit Hold'em Bounty
4781,1/16/2023 12:00:00 pm,WinStar World Casino,73459,NLH,100,80,20,0.8,No-Limit Hold'em
4782,1/16/2023 12:00:00 pm,Choctaw Casino Durant,74701,NLH,250,200,50,0.8,2022-23 WSOP Circuit Event (Dallas/Oklahoma-Winter) - Event #45 - No Limit Hold'em
4783,1/16/2023 4:00:00 pm,Choctaw Casino Durant,74701,HORSE,200,160,40,0.8,2022-23 WSOP Circuit Event (Dallas/Oklahoma-Winter) - Event #46 - H.O.R.S.E.
4784,1/16/2023 6:00:00 pm,Choctaw Casino Durant,74701,NLH,130,100,30,0.7692307692307693,2022-23 WSOP Circuit Event (Dallas/Oklahoma-Winter) - Event #47 - Deep Stack Nightly No-Limit Hold'em
4785,1/17/2023 12:00:00 pm,Choctaw Casino Durant,74701,NLH,130,100,30,0.7692307692307693,2022-23 WSOP Circuit Event (Dallas/Oklahoma-Winter) - Event #48 - No Limit Hold'em Seniors Ring Event (50+)
4786,1/17/2023 4:00:00 pm,Choctaw Casino Durant,74701,Stud8,200,160,40,0.8,2022-23 WSOP Circuit Event (Dallas/Oklahoma-Winter) - Event #49 - 7 Card Stud Hi/Lo
4787,1/17/2023 6:00:00 pm,WinStar World Casino,73459,NLH,100,80,20,0.8,No-Limit Hold'em
4788,1/17/2023 6:00:00 pm,Choctaw Casino Durant,74701,NLH,130,100,30,0.7692307692307693,2022-23 WSOP Circuit Event (Dallas/Oklahoma-Winter) - Event #50 - Deep Stack Nightly No-Limit Hold'em
4789,1/18/2023 12:00:00 pm,WinStar World Casino,73459,NLH,100,80,20,0.8,No-Limit Hold'em
4790,1/18/2023 12:00:00 pm,Choctaw Casino Durant,74701,NLH,300,240,60,0.8,2022-23 WSOP Circuit Event (Dallas/Oklahoma-Winter) - Event #51 - No-Limit Hold'em Super Monster
4791,1/18/2023 4:00:00 pm,Choctaw Casino Durant,74701,PLO,200,160,40,0.8,2022-23 WSOP Circuit Event (Dallas/Oklahoma-Winter) - Event #52 - PLO
4792,1/18/2023 6:00:00 pm,Choctaw Casino Durant,74701,NLH,130,100,30,0.7692307692307693,2022-23 WSOP Circuit Event (Dallas/Oklahoma-Winter) - Event #53 - Deep Stack Nightly No-Limit Hold'em
4793,1/18/2023 7:00:00 pm,Grand Casino Resort,74804,NLH,130,100,30,0.7692307692307693,No-Limit Hold'em
4794,1/19/2023 10:00:00 am,Choctaw Casino Durant,74701,NLH,70,50,20,0.7142857142857143,2022-23 WSOP Circuit Event (Dallas/Oklahoma-Winter) - Event #54 - Mega Satellite for Finale
4795,1/19/2023 12:00:00 pm,Choctaw Casino Durant,74701,NLH,300,240,60,0.8,2022-23 WSOP Circuit Event (Dallas/Oklahoma-Winter) - Event #55 - The Finale Championship
4796,1/19/2023 4:00:00 pm,Choctaw Casino Durant,74701,M,300,240,60,0.8,2022-23 WSOP Circuit Event (Dallas/Oklahoma-Winter) - Event #56 - 8-Game Mix
4797,1/19/2023 6:00:00 pm,WinStar World Casino,73459,NLH,100,80,20,0.8,No-Limit Hold'em
4798,1/19/2023 6:00:00 pm,Choctaw Casino Durant,74701,NLH,200,160,40,0.8,2022-23 WSOP Circuit Event (Dallas/Oklahoma-Winter) - Event #57 - No-Limit Hold'em Bounty
4799,1/19/2023 7:00:00 pm,Grand Casino Resort,74804,NLH,130,100,30,0.7692307692307693,No-Limit Hold'em
4800,1/20/2023 10:00:00 am,Choctaw Casino Durant,74701,NLH,70,50,20,0.7142857142857143,2022-23 WSOP Circuit Event (Dallas/Oklahoma-Winter) - Event #58 - Mega Satellite for Finale
4801,1/20/2023 12:00:00 pm,WinStar World Casino,73459,NLH,100,80,20,0.8,No-Limit Hold'em
4802,1/20/2023 12:00:00 pm,Choctaw Casino Durant,74701,NLH,300,240,60,0.8,2022-23 WSOP Circuit Event (Dallas/Oklahoma-Winter) - Event #55 - The Finale Championship
4803,1/20/2023 4:00:00 pm,Choctaw Casino Durant,74701,PLCngrs,200,160,40,0.8,2022-23 WSOP Circuit Event (Dallas/Oklahoma-Winter) - Event #59 - Congress
4804,1/20/2023 6:00:00 pm,Choctaw Casino Durant,74701,NLH,200,160,40,0.8,2022-23 WSOP Circuit Event (Dallas/Oklahoma-Winter) - Event #60 - No-Limit Hold'em Bounty
4805,1/21/2023 10:00:00 am,Choctaw Casino Durant,74701,NLH,70,50,20,0.7142857142857143,2022-23 WSOP Circuit Event (Dallas/Oklahoma-Winter) - Event #61 - Mega Satellite for Finale
4806,1/21/2023 12:00:00 pm,Choctaw Casino Durant,74701,NLH,300,240,60,0.8,2022-23 WSOP Circuit Event (Dallas/Oklahoma-Winter) - Event #55 - The Finale Championship
4807,1/21/2023 4:00:00 pm,Choctaw Casino Durant,74701,PLO,200,160,40,0.8,2022-23 WSOP Circuit Event (Dallas/Oklahoma-Winter) - Event #62 - PLO
4808,1/21/2023 6:00:00 pm,Choctaw Casino Durant,74701,NLH,200,160,40,0.8,2022-23 WSOP Circuit Event (Dallas/Oklahoma-Winter) - Event #63 - No-Limit Hold'em Bounty
4809,1/22/2023 12:00:00 pm,Choctaw Casino Durant,74701,NLH,200,160,40,0.8,2022-23 WSOP Circuit Event (Dallas/Oklahoma-Winter) - Event #64 - No-Limit Hold'em
4810,1/23/2023 12:00:00 pm,WinStar World Casino,73459,NLH,100,80,20,0.8,No-Limit Hold'em
4811,1/24/2023 6:00:00 pm,WinStar World Casino,73459,NLH,100,80,20,0.8,No-Limit Hold'em
4812,1/25/2023 12:00:00 pm,WinStar World Casino,73459,NLH,100,80,20,0.8,No-Limit Hold'em
4813,1/25/2023 7:00:00 pm,Grand Casino Resort,74804,NLH,130,100,30,0.7692307692307693,No-Limit Hold'em
4814,1/26/2023 6:00:00 pm,WinStar World Casino,73459,NLH,100,80,20,0.8,No-Limit Hold'em
4815,1/26/2023 7:00:00 pm,Grand Casino Resort,74804,NLH,130,100,30,0.7692307692307693,No-Limit Hold'em
4816,1/27/2023 12:00:00 pm,WinStar World Casino,73459,NLH,100,80,20,0.8,No-Limit Hold'em
4817,1/30/2023 12:00:00 pm,WinStar World Casino,73459,NLH,100,80,20,0.8,No-Limit Hold'em
4818,1/31/2023 6:00:00 pm,WinStar World Casino,73459,NLH,100,80,20,0.8,No-Limit Hold'em
4819,2/01/2023 12:00:00 pm,WinStar World Casino,73459,NLH,100,80,20,0.8,No-Limit Hold'em
4820,2/01/2023 7:00:00 pm,Grand Casino Resort,74804,NLH,130,100,30,0.7692307692307693,No-Limit Hold'em
4821,2/02/2023 6:00:00 pm,WinStar World Casino,73459,NLH,100,80,20,0.8,No-Limit Hold'em
4822,2/02/2023 7:00:00 pm,Grand Casino Resort,74804,NLH,130,100,30,0.7692307692307693,No-Limit Hold'em
4823,2/06/2023 12:00:00 pm,WinStar World Casino,73459,NLH,100,80,20,0.8,No-Limit Hold'em
4824,2/07/2023 6:00:00 pm,WinStar World Casino,73459,NLH,100,80,20,0.8,No-Limit Hold'em
4825,2/08/2023 12:00:00 pm,WinStar World Casino,73459,NLH,100,80,20,0.8,No-Limit Hold'em
4826,2/08/2023 7:00:00 pm,Grand Casino Resort,74804,NLH,130,100,30,0.7692307692307693,No-Limit Hold'em
4827,2/09/2023 6:00:00 pm,WinStar World Casino,73459,NLH,100,80,20,0.8,No-Limit Hold'em
4828,2/09/2023 7:00:00 pm,Grand Casino Resort,74804,NLH,130,100,30,0.7692307692307693,No-Limit Hold'em
4829,2/10/2023 12:00:00 pm,WinStar World Casino,73459,NLH,100,80,20,0.8,No-Limit Hold'em
4830,2/13/2023 12:00:00 pm,WinStar World Casino,73459,NLH,100,80,20,0.8,No-Limit Hold'em
4831,2/14/2023 6:00:00 pm,WinStar World Casino,73459,NLH,100,80,20,0.8,No-Limit Hold'em
4832,2/15/2023 12:00:00 pm,WinStar World Casino,73459,NLH,100,80,20,0.8,No-Limit Hold'em
4833,2/15/2023 7:00:00 pm,Grand Casino Resort,74804,NLH,130,100,30,0.7692307692307693,No-Limit Hold'em
4834,2/16/2023 6:00:00 pm,WinStar World Casino,73459,NLH,100,80,20,0.8,No-Limit Hold'em
4835,2/16/2023 7:00:00 pm,Grand Casino Resort,74804,NLH,130,100,30,0.7692307692307693,No-Limit Hold'em
4836,2/17/2023 12:00:00 pm,WinStar World Casino,73459,NLH,100,80,20,0.8,No-Limit Hold'em
4837,2/20/2023 12:00:00 pm,WinStar World Casino,73459,NLH,100,80,20,0.8,No-Limit Hold'em
4838,2/21/2023 6:00:00 pm,WinStar World Casino,73459,NLH,100,80,20,0.8,No-Limit Hold'em
4839,2/22/2023 12:00:00 pm,WinStar World Casino,73459,NLH,100,80,20,0.8,No-Limit Hold'em
4840,2/22/2023 7:00:00 pm,Grand Casino Resort,74804,NLH,130,100,30,0.7692307692307693,No-Limit Hold'em
4841,2/23/2023 6:00:00 pm,WinStar World Casino,73459,NLH,100,80,20,0.8,No-Limit Hold'em
4842,2/23/2023 7:00:00 pm,Grand Casino Resort,74804,NLH,130,100,30,0.7692307692307693,No-Limit Hold'em
4843,2/24/2023 12:00:00 pm,WinStar World Casino,73459,NLH,100,80,20,0.8,No-Limit Hold'em
4844,2/27/2023 12:00:00 pm,WinStar World Casino,73459,NLH,100,80,20,0.8,No-Limit Hold'em
4845,2/28/2023 6:00:00 pm,WinStar World Casino,73459,NLH,100,80,20,0.8,No-Limit Hold'em
4846,3/01/2023 12:00:00 pm,WinStar World Casino,73459,NLH,100,80,20,0.8,No-Limit Hold'em
4847,3/01/2023 7:00:00 pm,Grand Casino Resort,74804,NLH,130,100,30,0.7692307692307693,No-Limit Hold'em
4848,3/02/2023 6:00:00 pm,WinStar World Casino,73459,NLH,100,80,20,0.8,No-Limit Hold'em
4849,3/02/2023 7:00:00 pm,Grand Casino Resort,74804,NLH,130,100,30,0.7692307692307693,No-Limit Hold'em
4850,3/03/2023 12:00:00 pm,WinStar World Casino,73459,NLH,100,80,20,0.8,No-Limit Hold'em
4851,3/06/2023 12:00:00 pm,WinStar World Casino,73459,NLH,100,80,20,0.8,No-Limit Hold'em
4852,3/07/2023 6:00:00 pm,WinStar World Casino,73459,NLH,100,80,20,0.8,No-Limit Hold'em
4853,3/08/2023 12:00:00 pm,WinStar World Casino,73459,NLH,100,80,20,0.8,No-Limit Hold'em
4854,3/08/2023 7:00:00 pm,Grand Casino Resort,74804,NLH,130,100,30,0.7692307692307693,No-Limit Hold'em
4855,3/09/2023 6:00:00 pm,WinStar World Casino,73459,NLH,100,80,20,0.8,No-Limit Hold'em
4856,3/09/2023 7:00:00 pm,Grand Casino Resort,74804,NLH,130,100,30,0.7692307692307693,No-Limit Hold'em
4857,3/10/2023 12:00:00 pm,WinStar World Casino,73459,NLH,100,80,20,0.8,No-Limit Hold'em
4858,3/13/2023 12:00:00 pm,WinStar World Casino,73459,NLH,100,80,20,0.8,No-Limit Hold'em
4859,3/14/2023 6:00:00 pm,WinStar World Casino,73459,NLH,100,80,20,0.8,No-Limit Hold'em
4860,3/15/2023 12:00:00 pm,WinStar World Casino,73459,NLH,100,80,20,0.8,No-Limit Hold'em
4861,3/15/2023 7:00:00 pm,Grand Casino Resort,74804,NLH,130,100,30,0.7692307692307693,No-Limit Hold'em
4862,1/15/2023 3:00:00 pm,Indigo Sky Casino,74370,NLH,50,32,18,0.64,Crazy Pineapple
4863,1/15/2023 7:00:00 pm,River Spirit Casino,74137,NLH,75,60,15,0.8,Green Chip Bounty
4864,1/16/2023 7:00:00 pm,River Spirit Casino,74137,NLH,50,35,15,0.7,Monday Night Showdown
4865,1/17/2023 7:00:00 pm,River Spirit Casino,74137,NLH,75,60,15,0.8,Green Chip Bounty
4866,1/18/2023 7:00:00 pm,River Spirit Casino,74137,NLH,50,35,15,0.7,Wednesday Night Showdown
4867,1/18/2023 7:00:00 pm,Downstream Casino,74363,NLH,100,60,40,0.6,1-18-23 Added Money
4868,1/19/2023 7:00:00 pm,River Spirit Casino,74137,NLH,75,60,15,0.8,Green Chip Bounty
4869,1/20/2023 6:00:00 pm,Downstream Casino,74363,NLH,120,70,50,0.5833333333333334,1-20-23 Added Money
4870,1/20/2023 7:00:00 pm,River Spirit Casino,74137,NLH,65,50,15,0.7692307692307693,Friday Super Stack
4871,1/21/2023 3:00:00 pm,Downstream Casino,74363,NLH,200,150,50,0.75,1-21-23 Added Money
4872,1/21/2023 7:00:00 pm,River Spirit Casino,74137,NLH,50,35,15,0.7,Saturday Night Showdown
4873,1/22/2023 7:00:00 pm,River Spirit Casino,74137,NLH,75,60,15,0.8,Green Chip Bounty
4874,1/23/2023 7:00:00 pm,River Spirit Casino,74137,NLH,50,35,15,0.7,Monday Night Showdown
4875,1/24/2023 12:00:00 pm,Hard Rock Tulsa,74015,NLH,200,160,40,0.8,2023 RGPS Checkpoint: Tulsa - Series Event - Seniors (50+) NLH Ring Event
4876,1/24/2023 7:00:00 pm,River Spirit Casino,74137,NLH,75,60,15,0.8,Green Chip Bounty
4877,1/24/2023 7:00:00 pm,Hard Rock Tulsa,74015,NLH,165,130,35,0.7878787878787878,2023 RGPS Checkpoint: Tulsa - Series Event - Guest Bounty NLH Ring Event
4878,1/25/2023 12:00:00 pm,Hard Rock Tulsa,74015,NLH,250,200,50,0.8,2023 RGPS Checkpoint: Tulsa - Series Event - Deepstack NLH Ring Event
4879,1/25/2023 6:00:00 pm,Hard Rock Tulsa,74015,NLH,250,200,50,0.8,2023 RGPS Checkpoint: Tulsa - Series Event - Deepstack NLH Ring Event
4880,1/25/2023 7:00:00 pm,River Spirit Casino,74137,NLH,50,35,15,0.7,Wednesday Night Showdown
4881,1/25/2023 7:00:00 pm,Downstream Casino,74363,NLH,100,60,40,0.6,1-25-23 Added Money
4882,1/26/2023 1:00:00 pm,Hard Rock Tulsa,74015,NLH,200,160,40,0.8,2023 RGPS Checkpoint: Tulsa - Series Event - NLH Ring Event
4883,1/26/2023 6:00:00 pm,Hard Rock Tulsa,74015,NLH,200,160,40,0.8,2023 RGPS Checkpoint: Tulsa - Series Event - Two Green Chip Bounty NLH Ring Event
4884,1/26/2023 7:00:00 pm,River Spirit Casino,74137,NLH,75,60,15,0.8,Green Chip Bounty
4885,1/27/2023 12:00:00 pm,Hard Rock Tulsa,74015,PLO,300,250,50,0.8333333333333334,2023 RGPS Checkpoint: Tulsa - Series Event - PLO Ring Event
4886,1/27/2023 4:00:00 pm,Hard Rock Tulsa,74015,NLH,150,120,30,0.8,2023 RGPS Checkpoint: Tulsa - Satellite - Turbo Satellite to Main Event
4887,1/27/2023 6:00:00 pm,Downstream Casino,74363,NLH,130,80,50,0.6153846153846154,1-27-23 Added Money
4888,1/27/2023 6:00:00 pm,Hard Rock Tulsa,74015,NLH,600,520,80,0.8666666666666667,2023 RGPS Checkpoint: Tulsa - Series Event - Main Event NLH
4889,1/27/2023 7:00:00 pm,River Spirit Casino,74137,NLH,65,50,15,0.7692307692307693,Friday Super Stack
4890,1/28/2023 12:00:00 pm,Hard Rock Tulsa,74015,NLH,600,520,80,0.8666666666666667,2023 RGPS Checkpoint: Tulsa - Series Event - Main Event NLH
4891,1/28/2023 2:00:00 pm,Hard Rock Tulsa,74015,NLH,150,120,30,0.8,2023 RGPS Checkpoint: Tulsa - Satellite - Turbo Satellite to Main Event
4892,1/28/2023 3:00:00 pm,Downstream Casino,74363,NLH,175,125,50,0.7142857142857143,1-28-23 Added Money
4893,1/28/2023 6:00:00 pm,Hard Rock Tulsa,74015,NLH,600,520,80,0.8666666666666667,2023 RGPS Checkpoint: Tulsa - Series Event - Main Event NLH
4894,1/28/2023 7:00:00 pm,River Spirit Casino,74137,NLH,50,35,15,0.7,Saturday Night Showdown
4895,1/29/2023 1:00:00 pm,Hard Rock Tulsa,74015,NLH,200,160,40,0.8,2023 RGPS Checkpoint: Tulsa - Series Event - Turbo Closer NLH Ring Event
4896,1/29/2023 7:00:00 pm,River Spirit Casino,74137,NLH,75,60,15,0.8,Green Chip Bounty
4897,1/30/2023 7:00:00 pm,River Spirit Casino,74137,NLH,50,35,15,0.7,Monday Night Showdown
4898,1/31/2023 7:00:00 pm,River Spirit Casino,74137,NLH,75,60,15,0.8,Green Chip Bounty
4899,2/01/2023 7:00:00 pm,River Spirit Casino,74137,NLH,50,35,15,0.7,Wednesday Night Showdown
4900,2/02/2023 7:00:00 pm,River Spirit Casino,74137,NLH,75,60,15,0.8,Green Chip Bounty
4901,2/03/2023 7:00:00 pm,River Spirit Casino,74137,NLH,65,50,15,0.7692307692307693,Friday Super Stack
4902,2/04/2023 7:00:00 pm,River Spirit Casino,74137,NLH,50,35,15,0.7,Saturday Night Showdown
4903,2/05/2023 7:00:00 pm,River Spirit Casino,74137,NLH,75,60,15,0.8,Green Chip Bounty
4904,2/06/2023 7:00:00 pm,River Spirit Casino,74137,NLH,50,35,15,0.7,Monday Night Showdown
4905,2/07/2023 7:00:00 pm,River Spirit Casino,74137,NLH,75,60,15,0.8,Green Chip Bounty
4906,2/08/2023 7:00:00 pm,River Spirit Casino,74137,NLH,50,35,15,0.7,Wednesday Night Showdown
4907,2/09/2023 7:00:00 pm,River Spirit Casino,74137,NLH,75,60,15,0.8,Green Chip Bounty
4908,2/10/2023 7:00:00 pm,River Spirit Casino,74137,NLH,65,50,15,0.7692307692307693,Friday Super Stack
4909,2/11/2023 7:00:00 pm,River Spirit Casino,74137,NLH,50,35,15,0.7,Saturday Night Showdown
4910,2/12/2023 7:00:00 pm,River Spirit Casino,74137,NLH,75,60,15,0.8,Green Chip Bounty
4911,2/13/2023 7:00:00 pm,River Spirit Casino,74137,NLH,50,35,15,0.7,Monday Night Showdown
4912,2/14/2023 7:00:00 pm,River Spirit Casino,74137,NLH,75,60,15,0.8,Green Chip Bounty
4913,2/15/2023 7:00:00 pm,River Spirit Casino,74137,NLH,50,35,15,0.7,Wednesday Night Showdown
4914,2/16/2023 7:00:00 pm,River Spirit Casino,74137,NLH,75,60,15,0.8,Green Chip Bounty
4915,2/17/2023 7:00:00 pm,River Spirit Casino,74137,NLH,65,50,15,0.7692307692307693,Friday Super Stack
4916,2/18/2023 7:00:00 pm,River Spirit Casino,74137,NLH,50,35,15,0.7,Saturday Night Showdown
4917,2/19/2023 7:00:00 pm,River Spirit Casino,74137,NLH,75,60,15,0.8,Green Chip Bounty
4918,2/20/2023 7:00:00 pm,River Spirit Casino,74137,NLH,50,35,15,0.7,Monday Night Showdown
4919,2/23/2023 7:00:00 pm,River Spirit Casino,74137,NLH,75,60,15,0.8,Green Chip Bounty
4920,2/24/2023 7:00:00 pm,River Spirit Casino,74137,NLH,65,50,15,0.7692307692307693,Friday Super Stack
4921,2/25/2023 7:00:00 pm,River Spirit Casino,74137,NLH,50,35,15,0.7,Saturday Night Showdown
4922,2/26/2023 7:00:00 pm,River Spirit Casino,74137,NLH,75,60,15,0.8,Green Chip Bounty
4923,2/27/2023 7:00:00 pm,River Spirit Casino,74137,NLH,50,35,15,0.7,Monday Night Showdown
4924,2/28/2023 7:00:00 pm,River Spirit Casino,74137,NLH,75,60,15,0.8,Green Chip Bounty
4925,3/01/2023 7:00:00 pm,River Spirit Casino,74137,NLH,50,35,15,0.7,Wednesday Night Showdown
4926,3/02/2023 7:00:00 pm,River Spirit Casino,74137,NLH,75,60,15,0.8,Green Chip Bounty
4927,3/03/2023 7:00:00 pm,River Spirit Casino,74137,NLH,65,50,15,0.7692307692307693,Friday Super Stack
4928,3/04/2023 7:00:00 pm,River Spirit Casino,74137,NLH,50,35,15,0.7,Saturday Night Showdown
4929,3/05/2023 7:00:00 pm,River Spirit Casino,74137,NLH,75,60,15,0.8,Green Chip Bounty
4930,3/06/2023 7:00:00 pm,River Spirit Casino,74137,NLH,50,35,15,0.7,Monday Night Showdown
4931,3/07/2023 7:00:00 pm,River Spirit Casino,74137,NLH,75,60,15,0.8,Green Chip Bounty
4932,3/08/2023 7:00:00 pm,River Spirit Casino,74137,NLH,50,35,15,0.7,Wednesday Night Showdown
4933,3/09/2023 7:00:00 pm,River Spirit Casino,74137,NLH,75,60,15,0.8,Green Chip Bounty
4934,3/10/2023 7:00:00 pm,River Spirit Casino,74137,NLH,65,50,15,0.7692307692307693,Friday Super Stack
4935,3/11/2023 7:00:00 pm,River Spirit Casino,74137,NLH,50,35,15,0.7,Saturday Night Showdown
4936,3/12/2023 7:00:00 pm,River Spirit Casino,74137,NLH,75,60,15,0.8,Green Chip Bounty
4937,3/13/2023 7:00:00 pm,River Spirit Casino,74137,NLH,50,35,15,0.7,Monday Night Showdown
4938,3/14/2023 7:00:00 pm,River Spirit Casino,74137,NLH,75,60,15,0.8,Green Chip Bounty
4939,3/15/2023 7:00:00 pm,River Spirit Casino,74137,NLH,50,35,15,0.7,Wednesday Night Showdown
4940,1/15/2023 1:00:00 pm,Wildhorse Casino,97801,NLH,35,30,5,0.8571428571428571,NLH - $100 Added
4941,1/15/2023 3:00:00 pm,Jokers Casino,93422,NLH,70,55,15,0.7857142857142857,NLH
4942,1/15/2023 3:30:00 pm,Wild Goose Casino,98926,NLH,50,45,5,0.9,WSOP Satellite Qualifier
4943,1/16/2023 1:00:00 pm,Clearwater Saloon & Casino,98802,NLH,0,0,0,1.1,Freeroll
4944,1/16/2023 6:00:00 pm,Clearwater Saloon & Casino,98802,NLH,0,0,0,1.1,Freeroll
4945,1/16/2023 6:00:00 pm,Buzz Inn Casino & Steakhouse,98802,NLH,0,0,0,1.1,Freeroll
4946,1/17/2023 1:00:00 pm,Clearwater Saloon & Casino,98802,NLH,0,0,0,1.1,Freeroll
4947,1/17/2023 7:00:00 pm,Ontario Poker Room & Social Club,97914,NLH,20,10,10,0.5,NLH
4948,1/17/2023 6:00:00 pm,Clearwater Saloon & Casino,98802,NLH,0,0,0,1.1,Freeroll
4949,1/18/2023 6:00:00 pm,Buzz Inn Casino & Steakhouse,98802,NLH,40,35,5,0.875,NLH
4950,1/19/2023 6:00:00 pm,Clearwater Saloon & Casino,98802,NLH,0,0,0,1.1,Freeroll
4951,1/19/2023 6:30:00 pm,Wildhorse Casino,97801,NLH,55,50,5,0.9090909090909092,NLH - $200 Added
4952,1/20/2023 7:00:00 pm,Ontario Poker Room & Social Club,97914,NLH,25,15,10,0.6,Freaky Friday NLH w/Rebuys
4953,1/20/2023 6:30:00 pm,Wildhorse Casino,97801,NLH,80,70,10,0.875,NLH - $300 Added
4954,1/21/2023 1:00:00 pm,Wildhorse Casino,97801,NLH,115,100,15,0.8695652173913043,NLH - $500 Added
4955,1/21/2023 6:00:00 pm,Buzz Inn Casino & Steakhouse,98802,NLH,40,35,5,0.875,NLH
4956,1/21/2023 6:00:00 pm,Wild Goose Casino,98926,NLH,50,45,5,0.9,Deep Stack NLH
4957,1/22/2023 1:00:00 pm,Wildhorse Casino,97801,NLH,35,30,5,0.8571428571428571,NLH - $100 Added
4958,1/22/2023 3:00:00 pm,Jokers Casino,93422,NLH,70,55,15,0.7857142857142857,NLH
4959,1/22/2023 3:30:00 pm,Wild Goose Casino,98926,NLH,50,45,5,0.9,WSOP Satellite Qualifier
4960,1/23/2023 1:00:00 pm,Clearwater Saloon & Casino,98802,NLH,0,0,0,1.1,Freeroll
4961,1/23/2023 6:00:00 pm,Clearwater Saloon & Casino,98802,NLH,0,0,0,1.1,Freeroll
4962,1/23/2023 6:00:00 pm,Buzz Inn Casino & Steakhouse,98802,NLH,0,0,0,1.1,Freeroll
4963,1/24/2023 1:00:00 pm,Clearwater Saloon & Casino,98802,NLH,0,0,0,1.1,Freeroll
4964,1/24/2023 7:00:00 pm,Ontario Poker Room & Social Club,97914,NLH,20,10,10,0.5,NLH
4965,1/24/2023 6:00:00 pm,Clearwater Saloon & Casino,98802,NLH,0,0,0,1.1,Freeroll
4966,1/25/2023 6:00:00 pm,Buzz Inn Casino & Steakhouse,98802,NLH,40,35,5,0.875,NLH
4967,1/26/2023 6:00:00 pm,Clearwater Saloon & Casino,98802,NLH,0,0,0,1.1,Freeroll
4968,1/26/2023 6:30:00 pm,Wildhorse Casino,97801,NLH,55,50,5,0.9090909090909092,NLH - $200 Added
4969,1/27/2023 7:00:00 pm,Ontario Poker Room & Social Club,97914,NLH,25,15,10,0.6,Freaky Friday NLH w/Rebuys
4970,1/27/2023 6:30:00 pm,Wildhorse Casino,97801,NLH,80,70,10,0.875,NLH - $300 Added
4971,1/28/2023 1:00:00 pm,Wildhorse Casino,97801,NLH,115,100,15,0.8695652173913043,NLH - $500 Added
4972,1/28/2023 4:00:00 pm,Wild Goose Casino,98926,NLH,100,90,10,0.9,Last Saturday Golden Goose Tournament
4973,1/28/2023 6:00:00 pm,Buzz Inn Casino & Steakhouse,98802,NLH,40,35,5,0.875,NLH
4974,1/29/2023 1:00:00 pm,Wildhorse Casino,97801,NLH,35,30,5,0.8571428571428571,NLH - $100 Added
4975,1/29/2023 3:00:00 pm,Jokers Casino,93422,NLH,70,55,15,0.7857142857142857,NLH
4976,1/29/2023 3:30:00 pm,Wild Goose Casino,98926,NLH,50,45,5,0.9,WSOP Satellite Qualifier
4977,1/30/2023 1:00:00 pm,Clearwater Saloon & Casino,98802,NLH,0,0,0,1.1,Freeroll
4978,1/30/2023 6:00:00 pm,Clearwater Saloon & Casino,98802,NLH,0,0,0,1.1,Freeroll
4979,1/30/2023 6:00:00 pm,Buzz Inn Casino & Steakhouse,98802,NLH,0,0,0,1.1,Freeroll
4980,1/31/2023 1:00:00 pm,Clearwater Saloon & Casino,98802,NLH,0,0,0,1.1,Freeroll
4981,1/31/2023 7:00:00 pm,Ontario Poker Room & Social Club,97914,NLH,20,10,10,0.5,NLH
4982,1/31/2023 6:00:00 pm,Clearwater Saloon & Casino,98802,NLH,0,0,0,1.1,Freeroll
4983,2/01/2023 6:00:00 pm,Buzz Inn Casino & Steakhouse,98802,NLH,40,35,5,0.875,NLH
4984,2/02/2023 6:00:00 pm,Clearwater Saloon & Casino,98802,NLH,0,0,0,1.1,Freeroll
4985,2/02/2023 6:30:00 pm,Wildhorse Casino,97801,NLH,55,50,5,0.9090909090909092,NLH - $200 Added
4986,2/03/2023 7:00:00 pm,Ontario Poker Room & Social Club,97914,NLH,25,15,10,0.6,Freaky Friday NLH w/Rebuys
4987,2/03/2023 6:30:00 pm,Wildhorse Casino,97801,NLH,80,70,10,0.875,NLH - $300 Added
4988,2/04/2023 1:00:00 pm,Wildhorse Casino,97801,NLH,115,100,15,0.8695652173913043,NLH - $500 Added
4989,2/04/2023 6:00:00 pm,Buzz Inn Casino & Steakhouse,98802,NLH,40,35,5,0.875,NLH
4990,2/04/2023 6:00:00 pm,Wild Goose Casino,98926,NLH,50,45,5,0.9,Deep Stack NLH
4991,2/05/2023 1:00:00 pm,Wildhorse Casino,97801,NLH,35,30,5,0.8571428571428571,NLH - $100 Added
4992,2/05/2023 3:30:00 pm,Wild Goose Casino,98926,NLH,50,45,5,0.9,WSOP Satellite Qualifier
4993,2/06/2023 1:00:00 pm,Clearwater Saloon & Casino,98802,NLH,0,0,0,1.1,Freeroll
4994,2/06/2023 6:00:00 pm,Clearwater Saloon & Casino,98802,NLH,0,0,0,1.1,Freeroll
4995,2/06/2023 6:00:00 pm,Buzz Inn Casino & Steakhouse,98802,NLH,0,0,0,1.1,Freeroll
4996,2/07/2023 1:00:00 pm,Clearwater Saloon & Casino,98802,NLH,0,0,0,1.1,Freeroll
4997,2/07/2023 7:00:00 pm,Ontario Poker Room & Social Club,97914,NLH,20,10,10,0.5,NLH
4998,2/07/2023 6:00:00 pm,Clearwater Saloon & Casino,98802,NLH,0,0,0,1.1,Freeroll
4999,2/08/2023 6:00:00 pm,Buzz Inn Casino & Steakhouse,98802,NLH,40,35,5,0.875,NLH
5000,2/09/2023 6:00:00 pm,Clearwater Saloon & Casino,98802,NLH,0,0,0,1.1,Freeroll
5001,2/09/2023 6:30:00 pm,Wildhorse Casino,97801,NLH,55,50,5,0.9090909090909092,NLH - $200 Added
5002,2/10/2023 7:00:00 pm,Ontario Poker Room & Social Club,97914,NLH,25,15,10,0.6,Freaky Friday NLH w/Rebuys
5003,2/10/2023 6:30:00 pm,Wildhorse Casino,97801,NLH,80,70,10,0.875,NLH - $300 Added
5004,2/11/2023 1:00:00 pm,Wildhorse Casino,97801,NLH,115,100,15,0.8695652173913043,NLH - $500 Added
5005,2/11/2023 6:00:00 pm,Buzz Inn Casino & Steakhouse,98802,NLH,40,35,5,0.875,NLH
5006,2/11/2023 6:00:00 pm,Wild Goose Casino,98926,NLH,50,45,5,0.9,Deep Stack NLH
5007,2/12/2023 1:00:00 pm,Wildhorse Casino,97801,NLH,35,30,5,0.8571428571428571,NLH - $100 Added
5008,2/12/2023 3:00:00 pm,Jokers Casino,93422,NLH,70,55,15,0.7857142857142857,NLH
5009,2/12/2023 3:30:00 pm,Wild Goose Casino,98926,NLH,50,45,5,0.9,WSOP Satellite Qualifier
5010,2/13/2023 1:00:00 pm,Clearwater Saloon & Casino,98802,NLH,0,0,0,1.1,Freeroll
5011,2/13/2023 6:00:00 pm,Clearwater Saloon & Casino,98802,NLH,0,0,0,1.1,Freeroll
5012,2/13/2023 6:00:00 pm,Buzz Inn Casino & Steakhouse,98802,NLH,0,0,0,1.1,Freeroll
5013,2/14/2023 1:00:00 pm,Clearwater Saloon & Casino,98802,NLH,0,0,0,1.1,Freeroll
5014,2/14/2023 7:00:00 pm,Ontario Poker Room & Social Club,97914,NLH,20,10,10,0.5,NLH
5015,2/14/2023 6:00:00 pm,Clearwater Saloon & Casino,98802,NLH,0,0,0,1.1,Freeroll
5016,2/15/2023 6:00:00 pm,Buzz Inn Casino & Steakhouse,98802,NLH,40,35,5,0.875,NLH
5017,2/16/2023 6:00:00 pm,Clearwater Saloon & Casino,98802,NLH,0,0,0,1.1,Freeroll
5018,2/16/2023 6:30:00 pm,Wildhorse Casino,97801,NLH,55,50,5,0.9090909090909092,NLH - $200 Added
5019,2/17/2023 7:00:00 pm,Ontario Poker Room & Social Club,97914,NLH,25,15,10,0.6,Freaky Friday NLH w/Rebuys
5020,2/17/2023 6:30:00 pm,Wildhorse Casino,97801,NLH,80,70,10,0.875,NLH - $300 Added
5021,2/18/2023 1:00:00 pm,Wildhorse Casino,97801,NLH,115,100,15,0.8695652173913043,NLH - $500 Added
5022,2/18/2023 6:00:00 pm,Buzz Inn Casino & Steakhouse,98802,NLH,40,35,5,0.875,NLH
5023,2/18/2023 6:00:00 pm,Wild Goose Casino,98926,NLH,50,45,5,0.9,Deep Stack NLH
5024,2/19/2023 1:00:00 pm,Wildhorse Casino,97801,NLH,35,30,5,0.8571428571428571,NLH - $100 Added
5025,2/19/2023 3:00:00 pm,Jokers Casino,93422,NLH,70,55,15,0.7857142857142857,NLH
5026,2/19/2023 3:30:00 pm,Wild Goose Casino,98926,NLH,50,45,5,0.9,WSOP Satellite Qualifier
5027,2/20/2023 6:00:00 pm,Clearwater Saloon & Casino,98802,NLH,0,0,0,1.1,Freeroll
5028,2/20/2023 6:00:00 pm,Buzz Inn Casino & Steakhouse,98802,NLH,0,0,0,1.1,Freeroll
5029,2/21/2023 7:00:00 pm,Ontario Poker Room & Social Club,97914,NLH,20,10,10,0.5,NLH
5030,2/21/2023 6:00:00 pm,Clearwater Saloon & Casino,98802,NLH,0,0,0,1.1,Freeroll
5031,2/22/2023 6:00:00 pm,Buzz Inn Casino & Steakhouse,98802,NLH,40,35,5,0.875,NLH
5032,2/23/2023 6:00:00 pm,Clearwater Saloon & Casino,98802,NLH,0,0,0,1.1,Freeroll
5033,2/23/2023 6:30:00 pm,Wildhorse Casino,97801,NLH,55,50,5,0.9090909090909092,NLH - $200 Added
5034,2/24/2023 7:00:00 pm,Ontario Poker Room & Social Club,97914,NLH,25,15,10,0.6,Freaky Friday NLH w/Rebuys
5035,2/24/2023 6:30:00 pm,Wildhorse Casino,97801,NLH,80,70,10,0.875,NLH - $300 Added
5036,2/25/2023 1:00:00 pm,Wildhorse Casino,97801,NLH,115,100,15,0.8695652173913043,NLH - $500 Added
5037,2/25/2023 4:00:00 pm,Wild Goose Casino,98926,NLH,100,90,10,0.9,Last Saturday Golden Goose Tournament
5038,2/25/2023 6:00:00 pm,Buzz Inn Casino & Steakhouse,98802,NLH,40,35,5,0.875,NLH
5039,2/26/2023 1:00:00 pm,Wildhorse Casino,97801,NLH,35,30,5,0.8571428571428571,NLH - $100 Added
5040,2/26/2023 3:00:00 pm,Jokers Casino,93422,NLH,70,55,15,0.7857142857142857,NLH
5041,2/26/2023 3:30:00 pm,Wild Goose Casino,98926,NLH,50,45,5,0.9,WSOP Satellite Qualifier
5042,2/27/2023 1:00:00 pm,Clearwater Saloon & Casino,98802,NLH,0,0,0,1.1,Freeroll
5043,2/27/2023 6:00:00 pm,Clearwater Saloon & Casino,98802,NLH,0,0,0,1.1,Freeroll
5044,2/27/2023 6:00:00 pm,Buzz Inn Casino & Steakhouse,98802,NLH,0,0,0,1.1,Freeroll
5045,2/28/2023 1:00:00 pm,Clearwater Saloon & Casino,98802,NLH,0,0,0,1.1,Freeroll
5046,2/28/2023 7:00:00 pm,Ontario Poker Room & Social Club,97914,NLH,20,10,10,0.5,NLH
5047,2/28/2023 6:00:00 pm,Clearwater Saloon & Casino,98802,NLH,0,0,0,1.1,Freeroll
5048,3/01/2023 6:00:00 pm,Buzz Inn Casino & Steakhouse,98802,NLH,40,35,5,0.875,NLH
5049,3/02/2023 6:00:00 pm,Clearwater Saloon & Casino,98802,NLH,0,0,0,1.1,Freeroll
5050,3/02/2023 6:30:00 pm,Wildhorse Casino,97801,NLH,55,50,5,0.9090909090909092,NLH - $200 Added
5051,3/03/2023 7:00:00 pm,Ontario Poker Room & Social Club,97914,NLH,25,15,10,0.6,Freaky Friday NLH w/Rebuys
5052,3/03/2023 6:30:00 pm,Wildhorse Casino,97801,NLH,80,70,10,0.875,NLH - $300 Added
5053,3/04/2023 1:00:00 pm,Wildhorse Casino,97801,NLH,115,100,15,0.8695652173913043,NLH - $500 Added
5054,3/04/2023 6:00:00 pm,Buzz Inn Casino & Steakhouse,98802,NLH,40,35,5,0.875,NLH
5055,3/04/2023 6:00:00 pm,Wild Goose Casino,98926,NLH,50,45,5,0.9,Deep Stack NLH
5056,3/05/2023 1:00:00 pm,Wildhorse Casino,97801,NLH,35,30,5,0.8571428571428571,NLH - $100 Added
5057,3/05/2023 3:30:00 pm,Wild Goose Casino,98926,NLH,50,45,5,0.9,WSOP Satellite Qualifier
5058,3/06/2023 1:00:00 pm,Clearwater Saloon & Casino,98802,NLH,0,0,0,1.1,Freeroll
5059,3/06/2023 6:00:00 pm,Clearwater Saloon & Casino,98802,NLH,0,0,0,1.1,Freeroll
5060,3/06/2023 6:00:00 pm,Buzz Inn Casino & Steakhouse,98802,NLH,0,0,0,1.1,Freeroll
5061,3/07/2023 1:00:00 pm,Clearwater Saloon & Casino,98802,NLH,0,0,0,1.1,Freeroll
5062,3/07/2023 7:00:00 pm,Ontario Poker Room & Social Club,97914,NLH,20,10,10,0.5,NLH
5063,3/07/2023 6:00:00 pm,Clearwater Saloon & Casino,98802,NLH,0,0,0,1.1,Freeroll
5064,3/08/2023 6:00:00 pm,Buzz Inn Casino & Steakhouse,98802,NLH,40,35,5,0.875,NLH
5065,3/09/2023 6:00:00 pm,Clearwater Saloon & Casino,98802,NLH,0,0,0,1.1,Freeroll
5066,3/09/2023 6:30:00 pm,Wildhorse Casino,97801,NLH,55,50,5,0.9090909090909092,NLH - $200 Added
5067,3/10/2023 7:00:00 pm,Ontario Poker Room & Social Club,97914,NLH,25,15,10,0.6,Freaky Friday NLH w/Rebuys
5068,3/10/2023 6:30:00 pm,Wildhorse Casino,97801,NLH,80,70,10,0.875,NLH - $300 Added
5069,3/11/2023 1:00:00 pm,Wildhorse Casino,97801,NLH,115,100,15,0.8695652173913043,NLH - $500 Added
5070,3/11/2023 6:00:00 pm,Wild Goose Casino,98926,NLH,50,45,5,0.9,Deep Stack NLH
5071,3/11/2023 6:00:00 pm,Buzz Inn Casino & Steakhouse,98802,NLH,40,35,5,0.875,NLH
5072,3/12/2023 1:00:00 pm,Wildhorse Casino,97801,NLH,35,30,5,0.8571428571428571,NLH - $100 Added
5073,3/12/2023 3:00:00 pm,Jokers Casino,93422,NLH,70,55,15,0.7857142857142857,NLH
5074,3/12/2023 3:30:00 pm,Wild Goose Casino,98926,NLH,50,45,5,0.9,WSOP Satellite Qualifier
5075,3/13/2023 1:00:00 pm,Clearwater Saloon & Casino,98802,NLH,0,0,0,1.1,Freeroll
5076,3/13/2023 6:00:00 pm,Clearwater Saloon & Casino,98802,NLH,0,0,0,1.1,Freeroll
5077,3/13/2023 6:00:00 pm,Buzz Inn Casino & Steakhouse,98802,NLH,0,0,0,1.1,Freeroll
5078,3/14/2023 1:00:00 pm,Clearwater Saloon & Casino,98802,NLH,0,0,0,1.1,Freeroll
5079,3/14/2023 7:00:00 pm,Ontario Poker Room & Social Club,97914,NLH,20,10,10,0.5,NLH
5080,3/14/2023 6:00:00 pm,Clearwater Saloon & Casino,98802,NLH,0,0,0,1.1,Freeroll
5081,3/15/2023 6:00:00 pm,Buzz Inn Casino & Steakhouse,98802,NLH,40,35,5,0.875,NLH
5082,1/15/2023 9:00:00 am,The Last Frontier Casino,98629,NLH,60,45,15,0.75,NLH
5083,1/15/2023 12:00:00 pm,Medford Social Club Poker Room,97501,NLH,120,100,20,0.8333333333333334,NLH
5084,1/15/2023 12:00:00 pm,The Last Frontier Casino,98629,NLH,110,90,20,0.8181818181818182,NLH
5085,1/15/2023 1:00:00 pm,The Diamond Poker Club,97321,NLH,110,100,10,0.9090909090909092,Big Stack Freeze Out
5086,1/15/2023 7:00:00 pm,Portland Meadows,97218,NLH,60,40,20,0.6666666666666666,Freezeout
5087,1/16/2023 9:00:00 am,The Last Frontier Casino,98629,NLH,60,45,15,0.75,NLH
5088,1/16/2023 7:00:00 pm,Portland Meadows,97218,NLH,60,40,20,0.6666666666666666,Freezeout
5089,1/16/2023 7:00:00 pm,Full House Poker,97401,NLH,30,29,1,0.9666666666666668,Mulligan Tournament
5090,1/17/2023 9:00:00 am,The Last Frontier Casino,98629,NLH,60,45,15,0.75,NLH
5091,1/17/2023 11:00:00 am,The Diamond Poker Club,97321,FLO8,60,50,10,0.8333333333333334,Limit Omaha 8 or Better
5092,1/17/2023 7:00:00 pm,Portland Meadows,97218,NLH,60,40,20,0.6666666666666666,Freezeout
5093,1/18/2023 9:00:00 am,The Last Frontier Casino,98629,NLH,60,45,15,0.75,NLH
5094,1/18/2023 6:30:00 pm,The Diamond Poker Club,97321,NLH,50,40,10,0.8,NLH w/1 Rebuy
5095,1/18/2023 7:00:00 pm,Portland Meadows,97218,NLH,60,40,20,0.6666666666666666,Freezeout
5096,1/19/2023 9:00:00 am,The Last Frontier Casino,98629,NLH,60,45,15,0.75,NLH
5097,1/19/2023 7:00:00 pm,Portland Meadows,97218,NLH,60,40,20,0.6666666666666666,Freezeout
5098,1/20/2023 9:00:00 am,The Last Frontier Casino,98629,NLH,60,45,15,0.75,NLH
5099,1/20/2023 6:30:00 pm,The Diamond Poker Club,97321,NLH,80,70,10,0.875,Bounty
5100,1/21/2023 9:00:00 am,The Last Frontier Casino,98629,NLH,60,45,15,0.75,NLH
5101,1/21/2023 12:00:00 pm,The Last Frontier Casino,98629,NLH,110,90,20,0.8181818181818182,NLH
5102,1/21/2023 6:30:00 pm,The Diamond Poker Club,97321,NLH,70,60,10,0.8571428571428571,Resurrection Chip NLH
5103,1/22/2023 9:00:00 am,The Last Frontier Casino,98629,NLH,60,45,15,0.75,NLH
5104,1/22/2023 12:00:00 pm,Medford Social Club Poker Room,97501,NLH,120,100,20,0.8333333333333334,NLH
5105,1/22/2023 12:00:00 pm,The Last Frontier Casino,98629,NLH,110,90,20,0.8181818181818182,NLH
5106,1/22/2023 1:00:00 pm,The Diamond Poker Club,97321,NLH,110,100,10,0.9090909090909092,Big Stack Freeze Out
5107,1/22/2023 7:00:00 pm,Portland Meadows,97218,NLH,60,40,20,0.6666666666666666,Freezeout
5108,1/23/2023 9:00:00 am,The Last Frontier Casino,98629,NLH,60,45,15,0.75,NLH
5109,1/23/2023 7:00:00 pm,Portland Meadows,97218,NLH,60,40,20,0.6666666666666666,Freezeout
5110,1/24/2023 9:00:00 am,The Last Frontier Casino,98629,NLH,60,45,15,0.75,NLH
5111,1/24/2023 11:00:00 am,The Diamond Poker Club,97321,FLO8,60,50,10,0.8333333333333334,Limit Omaha 8 or Better
5112,1/24/2023 7:00:00 pm,Portland Meadows,97218,NLH,60,40,20,0.6666666666666666,Freezeout
5113,1/25/2023 9:00:00 am,The Last Frontier Casino,98629,NLH,60,45,15,0.75,NLH
5114,1/25/2023 6:30:00 pm,The Diamond Poker Club,97321,NLH,50,40,10,0.8,NLH w/1 Rebuy
5115,1/25/2023 7:00:00 pm,Portland Meadows,97218,NLH,60,40,20,0.6666666666666666,Freezeout
5116,1/26/2023 9:00:00 am,The Last Frontier Casino,98629,NLH,60,45,15,0.75,NLH
5117,1/26/2023 7:00:00 pm,Portland Meadows,97218,NLH,60,40,20,0.6666666666666666,Freezeout
5118,1/27/2023 9:00:00 am,The Last Frontier Casino,98629,NLH,60,45,15,0.75,NLH
5119,1/27/2023 6:30:00 pm,The Diamond Poker Club,97321,NLH,80,70,10,0.875,Bounty
5120,1/28/2023 9:00:00 am,The Last Frontier Casino,98629,NLH,60,45,15,0.75,NLH
5121,1/28/2023 12:00:00 pm,The Last Frontier Casino,98629,NLH,110,90,20,0.8181818181818182,NLH
5122,1/28/2023 6:30:00 pm,The Diamond Poker Club,97321,NLH,70,60,10,0.8571428571428571,Resurrection Chip NLH
5123,1/29/2023 9:00:00 am,The Last Frontier Casino,98629,NLH,60,45,15,0.75,NLH
5124,1/29/2023 12:00:00 pm,Medford Social Club Poker Room,97501,NLH,230,200,30,0.8695652173913043,Last Sunday of the Month NLH
5125,1/29/2023 12:00:00 pm,The Last Frontier Casino,98629,NLH,235,200,35,0.851063829787234,NLH
5126,1/29/2023 1:00:00 pm,The Diamond Poker Club,97321,NLH,110,100,10,0.9090909090909092,Big Stack Freeze Out
5127,1/29/2023 7:00:00 pm,Portland Meadows,97218,NLH,60,40,20,0.6666666666666666,Freezeout
5128,1/30/2023 9:00:00 am,The Last Frontier Casino,98629,NLH,60,45,15,0.75,NLH
5129,1/30/2023 7:00:00 pm,Portland Meadows,97218,NLH,60,40,20,0.6666666666666666,Freezeout
5130,1/30/2023 7:00:00 pm,Full House Poker,97401,NLH,30,29,1,0.9666666666666668,Mulligan Tournament
5131,1/31/2023 9:00:00 am,The Last Frontier Casino,98629,NLH,60,45,15,0.75,NLH
5132,1/31/2023 11:00:00 am,The Diamond Poker Club,97321,FLO8,60,50,10,0.8333333333333334,Limit Omaha 8 or Better
5133,1/31/2023 7:00:00 pm,Portland Meadows,97218,NLH,60,40,20,0.6666666666666666,Freezeout
5134,2/01/2023 9:00:00 am,The Last Frontier Casino,98629,NLH,60,45,15,0.75,NLH
5135,2/01/2023 6:30:00 pm,The Diamond Poker Club,97321,NLH,50,40,10,0.8,NLH w/1 Rebuy
5136,2/01/2023 7:00:00 pm,Portland Meadows,97218,NLH,60,40,20,0.6666666666666666,Freezeout
5137,2/02/2023 9:00:00 am,The Last Frontier Casino,98629,NLH,60,45,15,0.75,NLH
5138,2/02/2023 7:00:00 pm,Portland Meadows,97218,NLH,60,40,20,0.6666666666666666,Freezeout
5139,2/03/2023 6:30:00 pm,The Diamond Poker Club,97321,NLH,80,70,10,0.875,Bounty
5140,2/04/2023 12:00:00 pm,Grants Pass Poker Room,97526,NLH,120,100,20,0.8333333333333334,NLH
5141,2/04/2023 12:00:00 pm,The Last Frontier Casino,98629,NLH,110,90,20,0.8181818181818182,NLH
5142,2/04/2023 6:30:00 pm,The Diamond Poker Club,97321,NLH,70,60,10,0.8571428571428571,Resurrection Chip NLH
5143,2/05/2023 9:00:00 am,The Last Frontier Casino,98629,NLH,60,45,15,0.75,NLH
5144,2/05/2023 12:00:00 pm,Medford Social Club Poker Room,97501,NLH,120,100,20,0.8333333333333334,NLH
5145,2/05/2023 12:00:00 pm,The Last Frontier Casino,98629,NLH,110,90,20,0.8181818181818182,NLH
5146,2/05/2023 1:00:00 pm,The Diamond Poker Club,97321,NLH,110,100,10,0.9090909090909092,Big Stack Freeze Out
5147,2/05/2023 2:00:00 pm,Beach Poker Club,97402,NLH,135,135,ncludes dealer bonus,1.0,Big Stack
5148,2/05/2023 7:00:00 pm,Portland Meadows,97218,NLH,60,40,20,0.6666666666666666,Freezeout
5149,2/06/2023 9:00:00 am,The Last Frontier Casino,98629,NLH,60,45,15,0.75,NLH
5150,2/06/2023 7:00:00 pm,Portland Meadows,97218,NLH,60,40,20,0.6666666666666666,Freezeout
5151,2/07/2023 9:00:00 am,The Last Frontier Casino,98629,NLH,60,45,15,0.75,NLH
5152,2/07/2023 11:00:00 am,The Diamond Poker Club,97321,FLO8,60,50,10,0.8333333333333334,Limit Omaha 8 or Better
5153,2/07/2023 7:00:00 pm,Portland Meadows,97218,NLH,60,40,20,0.6666666666666666,Freezeout
5154,2/08/2023 9:00:00 am,The Last Frontier Casino,98629,NLH,60,45,15,0.75,NLH
5155,2/08/2023 6:30:00 pm,The Diamond Poker Club,97321,NLH,50,40,10,0.8,NLH w/1 Rebuy
5156,2/08/2023 7:00:00 pm,Portland Meadows,97218,NLH,60,40,20,0.6666666666666666,Freezeout
5157,2/09/2023 9:00:00 am,The Last Frontier Casino,98629,NLH,60,45,15,0.75,NLH
5158,2/09/2023 7:00:00 pm,Portland Meadows,97218,NLH,60,40,20,0.6666666666666666,Freezeout
5159,2/10/2023 9:00:00 am,The Last Frontier Casino,98629,NLH,60,45,15,0.75,NLH
5160,2/10/2023 6:30:00 pm,The Diamond Poker Club,97321,NLH,80,70,10,0.875,Bounty
5161,2/11/2023 9:00:00 am,The Last Frontier Casino,98629,NLH,60,45,15,0.75,NLH
5162,2/11/2023 12:00:00 pm,The Last Frontier Casino,98629,NLH,110,90,20,0.8181818181818182,NLH
5163,2/11/2023 6:30:00 pm,The Diamond Poker Club,97321,NLH,70,60,10,0.8571428571428571,Resurrection Chip NLH
5164,2/12/2023 9:00:00 am,The Last Frontier Casino,98629,NLH,60,45,15,0.75,NLH
5165,2/12/2023 12:00:00 pm,Medford Social Club Poker Room,97501,NLH,120,100,20,0.8333333333333334,NLH
5166,2/12/2023 12:00:00 pm,The Last Frontier Casino,98629,NLH,110,90,20,0.8181818181818182,NLH
5167,2/12/2023 1:00:00 pm,The Diamond Poker Club,97321,NLH,110,100,10,0.9090909090909092,Big Stack Freeze Out
5168,2/12/2023 7:00:00 pm,Portland Meadows,97218,NLH,60,40,20,0.6666666666666666,Freezeout
5169,2/13/2023 9:00:00 am,The Last Frontier Casino,98629,NLH,60,45,15,0.75,NLH
5170,2/13/2023 7:00:00 pm,Portland Meadows,97218,NLH,60,40,20,0.6666666666666666,Freezeout
5171,2/14/2023 9:00:00 am,The Last Frontier Casino,98629,NLH,60,45,15,0.75,NLH
5172,2/14/2023 11:00:00 am,The Diamond Poker Club,97321,FLO8,60,50,10,0.8333333333333334,Limit Omaha 8 or Better
5173,2/14/2023 7:00:00 pm,Portland Meadows,97218,NLH,60,40,20,0.6666666666666666,Freezeout
5174,2/15/2023 9:00:00 am,The Last Frontier Casino,98629,NLH,60,45,15,0.75,NLH
5175,2/15/2023 6:30:00 pm,The Diamond Poker Club,97321,NLH,50,40,10,0.8,NLH w/1 Rebuy
5176,2/15/2023 7:00:00 pm,Portland Meadows,97218,NLH,60,40,20,0.6666666666666666,Freezeout
5177,2/16/2023 9:00:00 am,The Last Frontier Casino,98629,NLH,60,45,15,0.75,NLH
5178,2/16/2023 7:00:00 pm,Portland Meadows,97218,NLH,60,40,20,0.6666666666666666,Freezeout
5179,2/17/2023 9:00:00 am,The Last Frontier Casino,98629,NLH,60,45,15,0.75,NLH
5180,2/17/2023 6:30:00 pm,The Diamond Poker Club,97321,NLH,80,70,10,0.875,Bounty
5181,2/18/2023 9:00:00 am,The Last Frontier Casino,98629,NLH,60,45,15,0.75,NLH
5182,2/18/2023 12:00:00 pm,The Last Frontier Casino,98629,NLH,110,90,20,0.8181818181818182,NLH
5183,2/18/2023 6:30:00 pm,The Diamond Poker Club,97321,NLH,70,60,10,0.8571428571428571,Resurrection Chip NLH
5184,2/19/2023 9:00:00 am,The Last Frontier Casino,98629,NLH,60,45,15,0.75,NLH
5185,2/19/2023 12:00:00 pm,Medford Social Club Poker Room,97501,NLH,120,100,20,0.8333333333333334,NLH
5186,2/19/2023 12:00:00 pm,The Last Frontier Casino,98629,NLH,110,90,20,0.8181818181818182,NLH
5187,2/19/2023 1:00:00 pm,The Diamond Poker Club,97321,NLH,110,100,10,0.9090909090909092,Big Stack Freeze Out
5188,2/19/2023 7:00:00 pm,Portland Meadows,97218,NLH,60,40,20,0.6666666666666666,Freezeout
5189,2/20/2023 9:00:00 am,The Last Frontier Casino,98629,NLH,60,45,15,0.75,NLH
5190,2/20/2023 7:00:00 pm,Portland Meadows,97218,NLH,60,40,20,0.6666666666666666,Freezeout
5191,2/21/2023 9:00:00 am,The Last Frontier Casino,98629,NLH,60,45,15,0.75,NLH
5192,2/21/2023 11:00:00 am,The Diamond Poker Club,97321,FLO8,60,50,10,0.8333333333333334,Limit Omaha 8 or Better
5193,2/21/2023 7:00:00 pm,Portland Meadows,97218,NLH,60,40,20,0.6666666666666666,Freezeout
5194,2/22/2023 9:00:00 am,The Last Frontier Casino,98629,NLH,60,45,15,0.75,NLH
5195,2/22/2023 6:30:00 pm,The Diamond Poker Club,97321,NLH,50,40,10,0.8,NLH w/1 Rebuy
5196,2/22/2023 7:00:00 pm,Portland Meadows,97218,NLH,60,40,20,0.6666666666666666,Freezeout
5197,2/23/2023 9:00:00 am,The Last Frontier Casino,98629,NLH,60,45,15,0.75,NLH
5198,2/23/2023 7:00:00 pm,Portland Meadows,97218,NLH,60,40,20,0.6666666666666666,Freezeout
5199,2/24/2023 9:00:00 am,The Last Frontier Casino,98629,NLH,60,45,15,0.75,NLH
5200,2/24/2023 6:30:00 pm,The Diamond Poker Club,97321,NLH,80,70,10,0.875,Bounty
5201,2/25/2023 9:00:00 am,The Last Frontier Casino,98629,NLH,60,45,15,0.75,NLH
5202,2/25/2023 12:00:00 pm,The Last Frontier Casino,98629,NLH,110,90,20,0.8181818181818182,NLH
5203,2/25/2023 6:30:00 pm,The Diamond Poker Club,97321,NLH,70,60,10,0.8571428571428571,Resurrection Chip NLH
5204,2/26/2023 9:00:00 am,The Last Frontier Casino,98629,NLH,60,45,15,0.75,NLH
5205,2/26/2023 12:00:00 pm,Medford Social Club Poker Room,97501,NLH,230,200,30,0.8695652173913043,Last Sunday of the Month NLH
5206,2/26/2023 12:00:00 pm,The Last Frontier Casino,98629,NLH,110,90,20,0.8181818181818182,NLH
5207,2/26/2023 1:00:00 pm,The Diamond Poker Club,97321,NLH,110,100,10,0.9090909090909092,Big Stack Freeze Out
5208,2/26/2023 7:00:00 pm,Portland Meadows,97218,NLH,60,40,20,0.6666666666666666,Freezeout
5209,2/27/2023 9:00:00 am,The Last Frontier Casino,98629,NLH,60,45,15,0.75,NLH
5210,2/27/2023 7:00:00 pm,Portland Meadows,97218,NLH,60,40,20,0.6666666666666666,Freezeout
5211,2/28/2023 9:00:00 am,The Last Frontier Casino,98629,NLH,60,45,15,0.75,NLH
5212,2/28/2023 11:00:00 am,The Diamond Poker Club,97321,FLO8,60,50,10,0.8333333333333334,Limit Omaha 8 or Better
5213,2/28/2023 7:00:00 pm,Portland Meadows,97218,NLH,60,40,20,0.6666666666666666,Freezeout
5214,3/01/2023 9:00:00 am,The Last Frontier Casino,98629,NLH,60,45,15,0.75,NLH
5215,3/01/2023 6:30:00 pm,The Diamond Poker Club,97321,NLH,50,40,10,0.8,NLH w/1 Rebuy
5216,3/01/2023 7:00:00 pm,Portland Meadows,97218,NLH,60,40,20,0.6666666666666666,Freezeout
5217,3/02/2023 9:00:00 am,The Last Frontier Casino,98629,NLH,60,45,15,0.75,NLH
5218,3/02/2023 7:00:00 pm,Portland Meadows,97218,NLH,60,40,20,0.6666666666666666,Freezeout
5219,3/03/2023 9:00:00 am,The Last Frontier Casino,98629,NLH,60,45,15,0.75,NLH
5220,3/03/2023 6:30:00 pm,The Diamond Poker Club,97321,NLH,80,70,10,0.875,Bounty
5221,3/04/2023 9:00:00 am,The Last Frontier Casino,98629,NLH,60,45,15,0.75,NLH
5222,3/04/2023 12:00:00 pm,Grants Pass Poker Room,97526,NLH,120,100,20,0.8333333333333334,NLH
5223,3/04/2023 12:00:00 pm,The Last Frontier Casino,98629,NLH,110,90,20,0.8181818181818182,NLH
5224,3/04/2023 6:30:00 pm,The Diamond Poker Club,97321,NLH,70,60,10,0.8571428571428571,Resurrection Chip NLH
5225,3/05/2023 9:00:00 am,The Last Frontier Casino,98629,NLH,60,45,15,0.75,NLH
5226,3/05/2023 1:00:00 pm,The Diamond Poker Club,97321,NLH,110,100,10,0.9090909090909092,Big Stack Freeze Out
5227,3/05/2023 2:00:00 pm,Beach Poker Club,97402,NLH,135,135,ncludes dealer bonus,1.0,Big Stack
5228,3/05/2023 7:00:00 pm,Portland Meadows,97218,NLH,60,40,20,0.6666666666666666,Freezeout
5229,3/06/2023 9:00:00 am,The Last Frontier Casino,98629,NLH,60,45,15,0.75,NLH
5230,3/06/2023 7:00:00 pm,Portland Meadows,97218,NLH,60,40,20,0.6666666666666666,Freezeout
5231,3/07/2023 9:00:00 am,The Last Frontier Casino,98629,NLH,60,45,15,0.75,NLH
5232,3/07/2023 11:00:00 am,The Diamond Poker Club,97321,FLO8,60,50,10,0.8333333333333334,Limit Omaha 8 or Better
5233,3/07/2023 7:00:00 pm,Portland Meadows,97218,NLH,60,40,20,0.6666666666666666,Freezeout
5234,3/08/2023 9:00:00 am,The Last Frontier Casino,98629,NLH,60,45,15,0.75,NLH
5235,3/08/2023 6:30:00 pm,The Diamond Poker Club,97321,NLH,50,40,10,0.8,NLH w/1 Rebuy
5236,3/08/2023 7:00:00 pm,Portland Meadows,97218,NLH,60,40,20,0.6666666666666666,Freezeout
5237,3/09/2023 9:00:00 am,The Last Frontier Casino,98629,NLH,60,45,15,0.75,NLH
5238,3/09/2023 7:00:00 pm,Portland Meadows,97218,NLH,60,40,20,0.6666666666666666,Freezeout
5239,3/10/2023 9:00:00 am,The Last Frontier Casino,98629,NLH,60,45,15,0.75,NLH
5240,3/10/2023 6:30:00 pm,The Diamond Poker Club,97321,NLH,80,70,10,0.875,Bounty
5241,3/11/2023 9:00:00 am,The Last Frontier Casino,98629,NLH,60,45,15,0.75,NLH
5242,3/11/2023 12:00:00 pm,The Last Frontier Casino,98629,NLH,110,90,20,0.8181818181818182,NLH
5243,3/11/2023 6:30:00 pm,The Diamond Poker Club,97321,NLH,70,60,10,0.8571428571428571,Resurrection Chip NLH
5244,3/12/2023 9:00:00 am,The Last Frontier Casino,98629,NLH,60,45,15,0.75,NLH
5245,3/12/2023 12:00:00 pm,Medford Social Club Poker Room,97501,NLH,120,100,20,0.8333333333333334,NLH
5246,3/12/2023 12:00:00 pm,The Last Frontier Casino,98629,NLH,110,90,20,0.8181818181818182,NLH
5247,3/12/2023 1:00:00 pm,The Diamond Poker Club,97321,NLH,110,100,10,0.9090909090909092,Big Stack Freeze Out
5248,3/12/2023 7:00:00 pm,Portland Meadows,97218,NLH,60,40,20,0.6666666666666666,Freezeout
5249,3/13/2023 9:00:00 am,The Last Frontier Casino,98629,NLH,60,45,15,0.75,NLH
5250,3/13/2023 7:00:00 pm,Portland Meadows,97218,NLH,60,40,20,0.6666666666666666,Freezeout
5251,3/14/2023 9:00:00 am,The Last Frontier Casino,98629,NLH,60,45,15,0.75,NLH
5252,3/14/2023 11:00:00 am,The Diamond Poker Club,97321,FLO8,60,50,10,0.8333333333333334,Limit Omaha 8 or Better
5253,3/14/2023 7:00:00 pm,Portland Meadows,97218,NLH,60,40,20,0.6666666666666666,Freezeout
5254,3/15/2023 9:00:00 am,The Last Frontier Casino,98629,NLH,60,45,15,0.75,NLH
5255,3/15/2023 6:30:00 pm,The Diamond Poker Club,97321,NLH,50,40,10,0.8,NLH w/1 Rebuy
5256,3/15/2023 7:00:00 pm,Portland Meadows,97218,NLH,60,40,20,0.6666666666666666,Freezeout
5257,3/16/2023 9:00:00 am,The Last Frontier Casino,98629,NLH,60,45,15,0.75,NLH
5258,1/15/2023 2:15:00 pm,Live! Casino Pittsburgh,15601,NLH,80,63,17,0.7875,Bankroll Builder
5259,1/17/2023 11:15:00 am,Live! Casino Pittsburgh,15601,NLH,120,95,25,0.7916666666666666,Fat Stacks Green Chip Bounty
5260,1/18/2023 6:15:00 pm,Live! Casino Pittsburgh,15601,NLH,80,63,17,0.7875,Bankroll Builder
5261,1/20/2023 12:00:00 pm,Rivers Casino-Pittsburgh,15212,NLH,160,125,35,0.78125,NLH
5262,1/20/2023 6:15:00 pm,Live! Casino Pittsburgh,15601,NLH,130,103,27,0.7923076923076923,Triple Stacks Turbo
5263,1/21/2023 11:15:00 am,Live! Casino Pittsburgh,15601,NLH,160,127,33,0.79375,Double Green Chip Bounty
5264,1/22/2023 2:15:00 pm,Live! Casino Pittsburgh,15601,NLH,80,63,17,0.7875,Bankroll Builder
5265,1/24/2023 11:15:00 am,Live! Casino Pittsburgh,15601,NLH,120,95,25,0.7916666666666666,Fat Stacks Green Chip Bounty
5266,1/25/2023 6:15:00 pm,Live! Casino Pittsburgh,15601,NLH,80,63,17,0.7875,Bankroll Builder
5267,1/27/2023 6:15:00 pm,Live! Casino Pittsburgh,15601,NLH,130,103,27,0.7923076923076923,Triple Stacks Turbo
5268,1/28/2023 11:00:00 am,Rivers Casino-Pittsburgh,15212,NLH,340,300,40,0.8823529411764706,Deep Stack NLH
5269,1/28/2023 11:15:00 am,Live! Casino Pittsburgh,15601,NLH,160,127,33,0.79375,Double Green Chip Bounty
5270,1/29/2023 2:15:00 pm,Live! Casino Pittsburgh,15601,NLH,80,63,17,0.7875,Bankroll Builder
5271,1/31/2023 11:15:00 am,Live! Casino Pittsburgh,15601,NLH,120,95,25,0.7916666666666666,Fat Stacks Green Chip Bounty
5272,2/01/2023 6:15:00 pm,Live! Casino Pittsburgh,15601,NLH,80,63,17,0.7875,Bankroll Builder
5273,2/03/2023 6:15:00 pm,Live! Casino Pittsburgh,15601,NLH,130,103,27,0.7923076923076923,Triple Stacks Turbo
5274,2/04/2023 11:15:00 am,Live! Casino Pittsburgh,15601,NLH,160,127,33,0.79375,Double Green Chip Bounty
5275,2/07/2023 11:15:00 am,Live! Casino Pittsburgh,15601,NLH,120,95,25,0.7916666666666666,Fat Stacks Green Chip Bounty
5276,2/08/2023 6:15:00 pm,Live! Casino Pittsburgh,15601,NLH,80,63,17,0.7875,Bankroll Builder
5277,2/10/2023 6:15:00 pm,Live! Casino Pittsburgh,15601,NLH,130,103,27,0.7923076923076923,Triple Stacks Turbo
5278,2/11/2023 11:15:00 am,Live! Casino Pittsburgh,15601,NLH,160,127,33,0.79375,Double Green Chip Bounty
5279,2/12/2023 2:15:00 pm,Live! Casino Pittsburgh,15601,NLH,80,63,17,0.7875,Bankroll Builder
5280,2/14/2023 11:15:00 am,Live! Casino Pittsburgh,15601,NLH,120,95,25,0.7916666666666666,Fat Stacks Green Chip Bounty
5281,2/15/2023 6:15:00 pm,Live! Casino Pittsburgh,15601,NLH,80,63,17,0.7875,Bankroll Builder
5282,2/17/2023 6:15:00 pm,Live! Casino Pittsburgh,15601,NLH,130,103,27,0.7923076923076923,Triple Stacks Turbo
5283,2/18/2023 11:15:00 am,Live! Casino Pittsburgh,15601,NLH,160,127,33,0.79375,Double Green Chip Bounty
5284,2/19/2023 2:15:00 pm,Live! Casino Pittsburgh,15601,NLH,80,63,17,0.7875,Bankroll Builder
5285,2/21/2023 11:15:00 am,Live! Casino Pittsburgh,15601,NLH,120,95,25,0.7916666666666666,Fat Stacks Green Chip Bounty
5286,2/22/2023 6:15:00 pm,Live! Casino Pittsburgh,15601,NLH,80,63,17,0.7875,Bankroll Builder
5287,2/24/2023 6:15:00 pm,Live! Casino Pittsburgh,15601,NLH,130,103,27,0.7923076923076923,Triple Stacks Turbo
5288,2/25/2023 11:15:00 am,Live! Casino Pittsburgh,15601,NLH,160,127,33,0.79375,Double Green Chip Bounty
5289,2/26/2023 2:15:00 pm,Live! Casino Pittsburgh,15601,NLH,80,63,17,0.7875,Bankroll Builder
5290,2/28/2023 11:15:00 am,Live! Casino Pittsburgh,15601,NLH,120,95,25,0.7916666666666666,Fat Stacks Green Chip Bounty
5291,3/01/2023 6:15:00 pm,Live! Casino Pittsburgh,15601,NLH,80,63,17,0.7875,Bankroll Builder
5292,3/03/2023 6:15:00 pm,Live! Casino Pittsburgh,15601,NLH,130,103,27,0.7923076923076923,Triple Stacks Turbo
5293,3/04/2023 11:15:00 am,Live! Casino Pittsburgh,15601,NLH,160,127,33,0.79375,Double Green Chip Bounty
5294,3/05/2023 2:15:00 pm,Live! Casino Pittsburgh,15601,NLH,80,63,17,0.7875,Bankroll Builder
5295,3/07/2023 11:15:00 am,Live! Casino Pittsburgh,15601,NLH,120,95,25,0.7916666666666666,Fat Stacks Green Chip Bounty
5296,3/08/2023 6:15:00 pm,Live! Casino Pittsburgh,15601,NLH,80,63,17,0.7875,Bankroll Builder
5297,3/10/2023 6:15:00 pm,Live! Casino Pittsburgh,15601,NLH,130,103,27,0.7923076923076923,Triple Stacks Turbo
5298,3/11/2023 11:15:00 am,Live! Casino Pittsburgh,15601,NLH,160,127,33,0.79375,Double Green Chip Bounty
5299,3/12/2023 2:15:00 pm,Live! Casino Pittsburgh,15601,NLH,80,63,17,0.7875,Bankroll Builder
5300,3/14/2023 11:15:00 am,Live! Casino Pittsburgh,15601,NLH,120,95,25,0.7916666666666666,Fat Stacks Green Chip Bounty
5301,3/15/2023 6:15:00 pm,Live! Casino Pittsburgh,15601,NLH,80,63,17,0.7875,Bankroll Builder
5302,1/15/2023 9:15:00 am,The Office Card House,78257,NLH,0,0,0,1.1,******30 Min Clock
5303,1/15/2023 10:15:00 am,The Lodge Poker Club,78664,NLH,50,34,16,0.68,DAILY KICKOFF
5304,1/15/2023 11:00:00 am,Texas Card House Dallas,75234,NLH,200,160,40,0.8,Sunday $5k GTD Re-Entry - $200 Buy In
5305,1/15/2023 11:10:00 am,Texas Card House Spring,77373,NLH,300,250,50,0.8333333333333334,"$150,000 GUARANTEE DAY 1G"
5306,1/15/2023 12:00:00 pm,Peaks Dallas,75207,NLH,0,0,0,1.1,Beginner Chess Lessons
5307,1/15/2023 12:00:00 pm,Doghouse Poker Club,77433,NLH,20,15,5,0.75,$500 GTD SUPER TURBO (9 Players Min)
5308,1/15/2023 12:15:00 pm,The Lodge Poker Club,78664,NLH,250,208,42,0.832,SUNDAY 15K FREEZEOUT
5309,1/15/2023 1:00:00 pm,Alpha Social Card Club,76301,NLH,200,160,40,0.8,$200 Sunday Special
5310,1/15/2023 1:00:00 pm,Shuffle 214,75218,NLH,50,20,30,0.4,$1500 Guarantee Bankroll Builder
5311,1/15/2023 1:00:00 pm,Poker House of Dallas,75247,NLH,130,100,30,0.7692307692307693,Sunday - $130 DeepStack Turbo
5312,1/15/2023 1:00:00 pm,Amarillo Social Club,79109,NLH,0,0,0,1.1,SUNDAY FUNDAY FREEBUY 1K GTD
5313,1/15/2023 2:00:00 pm,The Fort Card Room,76008,NLH,120,90,30,0.75,SUPER SATELLITE - WINTER GALA
5314,1/15/2023 2:00:00 pm,Prime Social Poker Club,77063,NLH,0,0,0,1.1,FREEROLL TO 100K 5 SEATS GTD
5315,1/15/2023 2:00:00 pm,Peaks Dallas,75207,NLH,30,30,0,1.0,"TJ's $30 DonkFest NLH $2,000 GTD"
5316,1/15/2023 2:00:00 pm,Rounders Card Club,78230,NLH,80,50,30,0.625,"$5,000 GTD Overlay! w/$1,000 ADDED!!"
5317,1/15/2023 2:00:00 pm,Paramount Social Club,77040,NLH,100,80,20,0.8,$3000 Sunday Deepstack
5318,1/15/2023 2:30:00 pm,Gin Mill Card Club Lubbock,79407,NLH,130,95,35,0.7307692307692307,**$130 Sunday True Freezeout
5319,1/15/2023 3:00:00 pm,Empire Poker Club Katy,77450,NLH,50,45,5,0.9,1000 DOUBLE STACK
5320,1/15/2023 3:00:00 pm,101 Poker Club,77449,PLO,20,0,20,0.0,$2k bomb pot TOURNEY
5321,1/15/2023 4:00:00 pm,Spades Poker House,77598,NLH,0,0,0,1.1,$2000 Guaranteed Freeroll
5322,1/15/2023 4:00:00 pm,Doghouse Poker Club,77433,NLH,0,0,0,1.1,"$2,500 GTD Freeroll NLH SHOWDOWN"
5323,1/15/2023 4:00:00 pm,Capri Poker Room,77598,NLH,0,0,0,1.1,"*$2,000 GTD FREEROLL! 1ST place GTD $1,000!"
5324,1/15/2023 4:00:00 pm,Empire Poker Club,77063,NLH,100,80,20,0.8,NLH Freezout
5325,1/15/2023 4:00:00 pm,Texas Card House Austin,78750,NLH,300,260,40,0.8666666666666667,$300 NLH Black Chip Bounty $5K
5326,1/15/2023 4:00:00 pm,The River League,76901,NLH,120,50,70,0.4166666666666667,$120 WSOP League Tournament
5327,1/15/2023 4:00:00 pm,Rounders Card Club,78230,PLO,45,20,25,0.4444444444444444,"DBL BD BOMB PLO $2,000 GTD"
5328,1/15/2023 5:00:00 pm,Georgetown Poker Club,78628,NLH,10,0,10,0.0,kontenders self deal freeroll
5329,1/15/2023 5:00:00 pm,The Hangar Poker House,77338,NLH,20,20,0,1.0,$1000 GTD Sunday Funday Tournament
5330,1/15/2023 5:00:00 pm,House of Kings Card Club,79935,NLH,5,0,5,0.0,FREE ROLL
5331,1/15/2023 6:00:00 pm,Texas Card House Dallas,75234,PLO,300,250,50,0.8333333333333334,Sunday 5k GTD PLO Blk Chip Bounty
5332,1/15/2023 6:00:00 pm,San Antonio Poker Palace,78232,NLH,60,40,20,0.6666666666666666,"*$5,000 GTD SUNDAY FUNDAY"
5333,1/15/2023 6:00:00 pm,KoJack's Poker Club,79701,PLO,260,220,40,0.8461538461538461,$260 PLO
5334,1/15/2023 6:00:00 pm,Shuffle 214,75218,NLH,130,100,30,0.7692307692307693,$5000 Guaranteed NLH
5335,1/15/2023 6:00:00 pm,Poker House of Dallas,75247,NLH,180,150,30,0.8333333333333334,Sunday - $180 Crazy Pineapple $50 Bounty
5336,1/15/2023 6:00:00 pm,Rounders Card Club,78230,NLH,25,0,25,0.0,"FREEROLL $1,000 GTD"
5337,1/15/2023 6:10:00 pm,Texas Card House Spring,77373,NLH,300,250,50,0.8333333333333334,"$150,000 GUARANTEE DAY 1H"
5338,1/15/2023 6:15:00 pm,The Lodge Poker Club,78664,NLH,200,164,36,0.82,SUNDAY NIGHT SURVIVOR
5339,1/15/2023 7:00:00 pm,The Fort Card Room,76008,FL8G,100,70,30,0.7,TEX-MIX
5340,1/15/2023 7:00:00 pm,Shuffle 512,78745,NLH,30,0,30,0.0,$1000 Guarantee Freeroll
5341,1/15/2023 7:00:00 pm,Paramount Social Club,77040,NLH,0,0,0,1.1,$1500 FREEROLL
5342,1/16/2023 9:15:00 am,The Office Card House,78257,NLH,0,0,0,1.1,*******30 Min Clock
5343,1/16/2023 10:15:00 am,The Lodge Poker Club,78664,NLH,50,34,16,0.68,DAILY KICKOFF
5344,1/16/2023 11:00:00 am,Texas Card House Dallas,75234,NLH,130,100,30,0.7692307692307693,MID DAY TURBO $3K GTD
5345,1/16/2023 12:00:00 pm,Doghouse Poker Club,77433,NLH,20,15,5,0.75,$500 GTD SUPER TURBO (9 Players Min)
5346,1/16/2023 12:00:00 pm,Prime Social Poker Club,77063,NLH,140,100,40,0.7142857142857143,5K GTD DAILY NLH
5347,1/15/2023 12:00:00 pm,Playground Poker Club,12919,NLH,220,175,45,0.7954545454545454,$220 Bounty Re-Entry
5348,1/15/2023 1:00:00 pm,Grand Royal Wolinak Casino,5829,NLH,70,60,10,0.8571428571428571,DIMANCHE TURBO
5349,1/15/2023 7:00:00 pm,Grand Royal Wolinak Casino,5829,NLH,70,60,10,0.8571428571428571,DIMANCHE TURBO
5350,1/16/2023 7:00:00 pm,Playground Poker Club,12919,NLH,180,140,40,0.7777777777777778,$180 Deepstack Turbo Re-Entry
5351,1/17/2023 7:00:00 pm,Playground Poker Club,12919,NLH,150,115,35,0.7666666666666667,$150 Re-Entry
5352,1/17/2023 8:00:00 pm,Playground Poker Club,12919,PLO,280,225,55,0.8035714285714286,$280 PLO5 Re-Entry
5353,1/18/2023 7:00:00 pm,Playground Poker Club,12919,NLH,280,225,55,0.8035714285714286,$280 Bounty Re-Entry
5354,1/19/2023 7:00:00 pm,Playground Poker Club,12919,NLH,420,350,70,0.8333333333333334,$420 Re-Entry
5355,1/21/2023 12:00:00 pm,Playground Poker Club,12919,NLH,180,140,40,0.7777777777777778,$180 Deepstack Turbo Re-Entry
5356,1/22/2023 12:00:00 pm,Playground Poker Club,12919,NLH,180,140,40,0.7777777777777778,Power Week January 2023 - Satellite - PW Jan 2023 - $180 Satellite Main Event 12PM
5357,1/22/2023 7:00:00 pm,Playground Poker Club,12919,NLH,180,140,40,0.7777777777777778,Power Week January 2023 - Satellite - PW Jan 2023 - $180 Satellite Main Event 7PM
5358,1/23/2023 7:00:00 pm,Playground Poker Club,12919,NLH,250,200,50,0.8,Power Week January 2023 - Event #1 - PW Jan 2023 Event #1 - $250 Deepstack Turbo
5359,1/24/2023 7:00:00 pm,Playground Poker Club,12919,NLH,280,225,55,0.8035714285714286,Power Week January 2023 - Event #2 - PW Jan 2023 Event #2 - $280 Single Re-Entry
5360,1/25/2023 7:00:00 pm,Playground Poker Club,12919,NLH,700,600,100,0.8571428571428571,Power Week January 2023 - Event #3 - PW Jan 2023 Event #3 - $700 Mystery Bounty
5361,1/26/2023 11:00:00 am,Playground Poker Club,12919,NLH,500,425,75,0.85,Power Week January 2023 - Event #4 - PW Jan 2023 Event #4 - $500 Bounty
5362,1/26/2023 7:00:00 pm,Playground Poker Club,12919,NLH,285,230,55,0.8070175438596491,Power Week January 2023 - Satellite - PW Jan 2023 - $285 Satellite Main Event 7PM
5363,1/27/2023 11:00:00 am,Playground Poker Club,12919,NLH,1150,1000,150,0.8695652173913043,"Power Week January 2023 - Event #5 - PW Jan 2023 Event #5 - Day 1A - $1,150 Main Event"
5364,1/28/2023 11:00:00 am,Playground Poker Club,12919,NLH,1150,1000,150,0.8695652173913043,"Power Week January 2023 - Event #5 - PW Jan 2023 Event #5 - Day 1B - $1,150 Main Event"
5365,1/28/2023 6:00:00 pm,Playground Poker Club,12919,PLBig O,725,620,105,0.8551724137931035,Power Week January 2023 - Event #6 - PW Jan 2023 Event #6 - $725 PLO 5
5366,1/29/2023 1:00:00 pm,Playground Poker Club,12919,NLH,2200,2000,200,0.9090909090909092,"Power Week January 2023 - Event #7 - PW Jan 2023 Event #7 - $2,200 Second Chance"
5367,1/29/2023 7:00:00 pm,Playground Poker Club,12919,NLH,280,225,55,0.8035714285714286,Power Week January 2023 - Event #8 - PW Jan 2023 Event #8 - $280 Mystery Bounty
5368,1/30/2023 7:00:00 pm,Playground Poker Club,12919,NLH,180,140,40,0.7777777777777778,$180 Deepstack Turbo Re-Entry
5369,1/31/2023 7:00:00 pm,Playground Poker Club,12919,NLH,150,115,35,0.7666666666666667,$150 Re-Entry
5370,1/31/2023 8:00:00 pm,Playground Poker Club,12919,PLO,280,225,55,0.8035714285714286,$280 PLO5 Re-Entry
5371,2/01/2023 7:00:00 pm,Playground Poker Club,12919,NLH,280,225,55,0.8035714285714286,$280 Bounty Re-Entry
5372,2/02/2023 7:00:00 pm,Playground Poker Club,12919,NLH,420,350,70,0.8333333333333334,$420 Re-Entry
5373,2/04/2023 12:00:00 pm,Playground Poker Club,12919,NLH,180,140,40,0.7777777777777778,$180 Deepstack Turbo Re-Entry
5374,2/05/2023 12:00:00 pm,Playground Poker Club,12919,NLH,220,175,45,0.7954545454545454,$220 Bounty Re-Entry
5375,2/06/2023 7:00:00 pm,Playground Poker Club,12919,NLH,180,140,40,0.7777777777777778,$180 Deepstack Turbo Re-Entry
5376,2/07/2023 7:00:00 pm,Playground Poker Club,12919,NLH,150,115,35,0.7666666666666667,$150 Re-Entry
5377,2/07/2023 8:00:00 pm,Playground Poker Club,12919,PLO,280,225,55,0.8035714285714286,$280 PLO5 Re-Entry
5378,2/08/2023 7:00:00 pm,Playground Poker Club,12919,NLH,280,225,55,0.8035714285714286,$280 Bounty Re-Entry
5379,2/09/2023 7:00:00 pm,Playground Poker Club,12919,NLH,420,350,70,0.8333333333333334,$420 Re-Entry
5380,2/11/2023 12:00:00 pm,Playground Poker Club,12919,NLH,180,140,40,0.7777777777777778,$180 Deepstack Turbo Re-Entry
5381,2/12/2023 12:00:00 pm,Playground Poker Club,12919,NLH,220,175,45,0.7954545454545454,$220 Bounty Re-Entry
5382,2/13/2023 7:00:00 pm,Playground Poker Club,12919,NLH,180,140,40,0.7777777777777778,$180 Deepstack Turbo Re-Entry
5383,2/14/2023 7:00:00 pm,Playground Poker Club,12919,NLH,150,115,35,0.7666666666666667,$150 Re-Entry
5384,2/14/2023 8:00:00 pm,Playground Poker Club,12919,PLO,280,225,55,0.8035714285714286,$280 PLO5 Re-Entry
5385,2/15/2023 7:00:00 pm,Playground Poker Club,12919,NLH,280,225,55,0.8035714285714286,$280 Bounty Re-Entry
5386,2/16/2023 7:00:00 pm,Playground Poker Club,12919,NLH,420,350,70,0.8333333333333334,$420 Re-Entry
5387,2/18/2023 12:00:00 pm,Playground Poker Club,12919,NLH,180,140,40,0.7777777777777778,$180 Deepstack Turbo Re-Entry
5388,1/15/2023 10:00:00 am,Fortune Lacey Casino & Poker,98516,NLH,60,45,15,0.75,NLH
5389,1/16/2023 10:00:00 am,Fortune Lacey Casino & Poker,98516,NLH,60,45,15,0.75,NLH
5390,1/17/2023 10:00:00 am,Fortune Lacey Casino & Poker,98516,NLH,60,45,15,0.75,NLH
5391,1/18/2023 10:00:00 am,Fortune Lacey Casino & Poker,98516,NLH,60,45,15,0.75,NLH
5392,1/19/2023 10:00:00 am,Fortune Lacey Casino & Poker,98516,NLH,60,45,15,0.75,NLH
5393,1/20/2023 10:00:00 am,Fortune Lacey Casino & Poker,98516,NLH,60,45,15,0.75,NLH
5394,1/21/2023 10:00:00 am,Fortune Lacey Casino & Poker,98516,NLH,60,45,15,0.75,NLH
5395,1/22/2023 10:00:00 am,Fortune Lacey Casino & Poker,98516,NLH,60,45,15,0.75,NLH
5396,1/23/2023 10:00:00 am,Fortune Lacey Casino & Poker,98516,NLH,60,45,15,0.75,NLH
5397,1/24/2023 10:00:00 am,Fortune Lacey Casino & Poker,98516,NLH,60,45,15,0.75,NLH
5398,1/25/2023 10:00:00 am,Fortune Lacey Casino & Poker,98516,NLH,60,45,15,0.75,NLH
5399,1/26/2023 10:00:00 am,Fortune Lacey Casino & Poker,98516,NLH,60,45,15,0.75,NLH
5400,1/27/2023 10:00:00 am,Fortune Lacey Casino & Poker,98516,NLH,60,45,15,0.75,NLH
5401,1/28/2023 10:00:00 am,Fortune Lacey Casino & Poker,98516,NLH,60,45,15,0.75,NLH
5402,1/29/2023 10:00:00 am,Fortune Lacey Casino & Poker,98516,NLH,60,45,15,0.75,NLH
5403,1/30/2023 10:00:00 am,Fortune Lacey Casino & Poker,98516,NLH,60,45,15,0.75,NLH
5404,1/31/2023 10:00:00 am,Fortune Lacey Casino & Poker,98516,NLH,60,45,15,0.75,NLH
5405,2/01/2023 10:00:00 am,Fortune Lacey Casino & Poker,98516,NLH,60,45,15,0.75,NLH
5406,2/02/2023 10:00:00 am,Fortune Lacey Casino & Poker,98516,NLH,60,45,15,0.75,NLH
5407,2/03/2023 10:00:00 am,Fortune Lacey Casino & Poker,98516,NLH,60,45,15,0.75,NLH
5408,2/04/2023 10:00:00 am,Fortune Lacey Casino & Poker,98516,NLH,60,45,15,0.75,NLH
5409,2/05/2023 10:00:00 am,Fortune Lacey Casino & Poker,98516,NLH,60,45,15,0.75,NLH
5410,2/06/2023 10:00:00 am,Fortune Lacey Casino & Poker,98516,NLH,60,45,15,0.75,NLH
5411,2/07/2023 10:00:00 am,Fortune Lacey Casino & Poker,98516,NLH,60,45,15,0.75,NLH
5412,2/08/2023 10:00:00 am,Fortune Lacey Casino & Poker,98516,NLH,60,45,15,0.75,NLH
5413,2/09/2023 10:00:00 am,Fortune Lacey Casino & Poker,98516,NLH,60,45,15,0.75,NLH
5414,2/10/2023 10:00:00 am,Fortune Lacey Casino & Poker,98516,NLH,60,45,15,0.75,NLH
5415,2/11/2023 10:00:00 am,Fortune Lacey Casino & Poker,98516,NLH,60,45,15,0.75,NLH
5416,2/12/2023 10:00:00 am,Fortune Lacey Casino & Poker,98516,NLH,60,45,15,0.75,NLH
5417,2/13/2023 10:00:00 am,Fortune Lacey Casino & Poker,98516,NLH,60,45,15,0.75,NLH
5418,2/14/2023 10:00:00 am,Fortune Lacey Casino & Poker,98516,NLH,60,45,15,0.75,NLH
5419,2/15/2023 10:00:00 am,Fortune Lacey Casino & Poker,98516,NLH,60,45,15,0.75,NLH
5420,2/16/2023 10:00:00 am,Fortune Lacey Casino & Poker,98516,NLH,60,45,15,0.75,NLH
5421,2/17/2023 10:00:00 am,Fortune Lacey Casino & Poker,98516,NLH,60,45,15,0.75,NLH
5422,2/18/2023 10:00:00 am,Fortune Lacey Casino & Poker,98516,NLH,60,45,15,0.75,NLH
5423,2/19/2023 10:00:00 am,Fortune Lacey Casino & Poker,98516,NLH,60,45,15,0.75,NLH
5424,2/20/2023 10:00:00 am,Fortune Lacey Casino & Poker,98516,NLH,60,45,15,0.75,NLH
5425,2/21/2023 10:00:00 am,Fortune Lacey Casino & Poker,98516,NLH,60,45,15,0.75,NLH
5426,2/22/2023 10:00:00 am,Fortune Lacey Casino & Poker,98516,NLH,60,45,15,0.75,NLH
5427,2/23/2023 10:00:00 am,Fortune Lacey Casino & Poker,98516,NLH,60,45,15,0.75,NLH
5428,2/24/2023 10:00:00 am,Fortune Lacey Casino & Poker,98516,NLH,60,45,15,0.75,NLH
5429,2/25/2023 10:00:00 am,Fortune Lacey Casino & Poker,98516,NLH,60,45,15,0.75,NLH
5430,2/26/2023 10:00:00 am,Fortune Lacey Casino & Poker,98516,NLH,60,45,15,0.75,NLH
5431,2/27/2023 10:00:00 am,Fortune Lacey Casino & Poker,98516,NLH,60,45,15,0.75,NLH
5432,2/28/2023 10:00:00 am,Fortune Lacey Casino & Poker,98516,NLH,60,45,15,0.75,NLH
5433,3/01/2023 10:00:00 am,Fortune Lacey Casino & Poker,98516,NLH,60,45,15,0.75,NLH
5434,3/02/2023 10:00:00 am,Fortune Lacey Casino & Poker,98516,NLH,60,45,15,0.75,NLH
5435,3/03/2023 10:00:00 am,Fortune Lacey Casino & Poker,98516,NLH,60,45,15,0.75,NLH
5436,3/04/2023 10:00:00 am,Fortune Lacey Casino & Poker,98516,NLH,60,45,15,0.75,NLH
5437,3/05/2023 10:00:00 am,Fortune Lacey Casino & Poker,98516,NLH,60,45,15,0.75,NLH
5438,3/06/2023 10:00:00 am,Fortune Lacey Casino & Poker,98516,NLH,60,45,15,0.75,NLH
5439,3/07/2023 10:00:00 am,Fortune Lacey Casino & Poker,98516,NLH,60,45,15,0.75,NLH
5440,3/08/2023 10:00:00 am,Fortune Lacey Casino & Poker,98516,NLH,60,45,15,0.75,NLH
5441,3/09/2023 10:00:00 am,Fortune Lacey Casino & Poker,98516,NLH,60,45,15,0.75,NLH
5442,3/10/2023 10:00:00 am,Fortune Lacey Casino & Poker,98516,NLH,60,45,15,0.75,NLH
5443,3/11/2023 10:00:00 am,Fortune Lacey Casino & Poker,98516,NLH,60,45,15,0.75,NLH
5444,3/12/2023 10:00:00 am,Fortune Lacey Casino & Poker,98516,NLH,60,45,15,0.75,NLH
5445,3/13/2023 10:00:00 am,Fortune Lacey Casino & Poker,98516,NLH,60,45,15,0.75,NLH
5446,3/14/2023 10:00:00 am,Fortune Lacey Casino & Poker,98516,NLH,60,45,15,0.75,NLH
5447,3/15/2023 10:00:00 am,Fortune Lacey Casino & Poker,98516,NLH,60,45,15,0.75,NLH
5448,3/16/2023 10:00:00 am,Fortune Lacey Casino & Poker,98516,NLH,60,45,15,0.75,NLH
5449,1/15/2023 10:00:00 am,Casino Caribbean Kirkland,98034,NLH,50,35,15,0.7,NLH
5450,1/15/2023 10:00:00 am,Red Dragon Casino,89103,NLH,50,35,15,0.7,NLH
5451,1/15/2023 10:30:00 am,Jamestown Saloon,98223,NLH,120,100,20,0.8333333333333334,NLH Bounty
5452,1/15/2023 12:00:00 pm,Roxbury Lanes Casino,98126,NLH,50,35,15,0.7,NLH
5453,1/15/2023 2:00:00 pm,Casino Caribbean Kirkland,98034,NLH,200,150,50,0.75,NLH
5454,1/16/2023 10:00:00 am,Red Dragon Casino,89103,NLH,50,35,15,0.7,NLH
5455,1/16/2023 12:00:00 pm,Roxbury Lanes Casino,98126,NLH,50,35,15,0.7,NLH
5456,1/16/2023 2:00:00 pm,Casino Caribbean Kirkland,98034,NLH,130,100,30,0.7692307692307693,NLH Bounty
5457,1/16/2023 7:00:00 pm,Oak Harbor Card Room,98277,NLH,35,30,5,0.8571428571428571,NLH
5458,1/16/2023 7:00:00 pm,Red Dragon Casino,89103,NLH,75,60,15,0.8,NLH Bounty
5459,1/17/2023 10:00:00 am,Casino Caribbean Kirkland,98034,NLH,50,35,15,0.7,NLH
5460,1/17/2023 10:00:00 am,Red Dragon Casino,89103,NLH,50,35,15,0.7,NLH
5461,1/17/2023 12:00:00 pm,Roxbury Lanes Casino,98126,NLH,50,35,15,0.7,NLH
5462,1/17/2023 6:00:00 pm,Casino Caribbean Kirkland,98034,NLH,75,60,15,0.8,NLH Bounty
5463,1/18/2023 10:00:00 am,Casino Caribbean Kirkland,98034,NLH,50,35,15,0.7,NLH Be the Boss Bounty
5464,1/18/2023 10:00:00 am,Red Dragon Casino,89103,NLH,50,35,15,0.7,NLH
5465,1/18/2023 12:00:00 pm,Roxbury Lanes Casino,98126,NLH,50,35,15,0.7,NLH
5466,1/18/2023 7:00:00 pm,Red Dragon Casino,89103,NLH,75,60,15,0.8,NLH Bounty
5467,1/19/2023 10:00:00 am,Casino Caribbean Kirkland,98034,NLH,50,35,15,0.7,NLH
5468,1/19/2023 10:00:00 am,Red Dragon Casino,89103,NLH,50,35,15,0.7,NLH
5469,1/19/2023 12:00:00 pm,Roxbury Lanes Casino,98126,NLH,50,35,15,0.7,NLH
5470,1/19/2023 6:00:00 pm,Casino Caribbean Kirkland,98034,NLH,75,60,15,0.8,NLH Bounty
5471,1/20/2023 10:00:00 am,Red Dragon Casino,89103,NLH,130,100,30,0.7692307692307693,NLH
5472,1/20/2023 10:30:00 am,Jamestown Saloon,98223,NLH,60,50,10,0.8333333333333334,NLH
5473,1/20/2023 12:00:00 pm,Roxbury Lanes Casino,98126,NLH,50,35,15,0.7,NLH
5474,1/20/2023 2:00:00 pm,Casino Caribbean Kirkland,98034,NLH,130,100,30,0.7692307692307693,NLH
